亚美尼亚 人类发展指数	数字	单个
滦河 流域面积	数字+单位	单个
历山国家级自然保护区 批准时间	数字+单位	单个
奥胡斯 行政代码	数字	单个
弗洛勒斯海 最深处	数字+单位	单个
孟买 行政代码	数字	单个
德宏傣族景颇族自治州 GDP	数字+单位	单个
英属维尔京群岛 国歌	百科实体	句子
凉山彝族自治州 高等院校	地名	多个
卡塔尔 主要城市	百科实体	多个
湖北省 历史名人	人名	多个
吉达 著名景点	百科实体	多个
泰州市 现任领导	人名	多个
克利夫兰 行政代码	数字	单个
日本 国花	百科实体	单个
平凉市 地区生产总值	数字+单位	单个
呼伦贝尔市 高等院校	地名	多个
锡林郭勒盟 行政代码	数字	单个
滨州市 高等院校	地名	多个
马山国家级自然保护区 批准时间	数字+单位	单个
塞浦路斯 国花	百科实体	单个
密西西比河 河长	数字+单位	单个
和田河 流域面积	数字+单位	单个
波河平原 面积	数字+单位	单个
克利夫兰 邮政区码	数字	单个
安大略湖 建议游玩时长	数字+单位	单个
班加罗尔 面积	数字+单位	单个
德班 下辖地区	数字+单位	多个
班加罗尔 下辖地区	数字+单位	多个
湘江 主要支流	百科实体	多个
徐闻珊瑚礁国家级自然保护区 批准时间	数字+单位	单个
直布罗陀 国歌	百科实体	句子
乍得 水域率	数字+单位	单个
北马里亚纳 主要民族	百科实体	多个
萨那 邮政区码	数字	单个
基加利 邮政区码	数字	单个
丹霞山国家级自然保护区 占地面积	数字+单位	单个
赣江 河流面积	数字+单位	单个
宝天曼国家级自然保护区 占地面积	数字+单位	单个
加那利群岛 主要城市	百科实体	多个
匹兹堡 行政代码	数字	单个
菏泽市 地区生产总值	数字+单位	单个
坝王岭国家级自然保护区 占地面积	数字+单位	单个
瓜德罗普 GDP总计	数字+单位	单个
六盘水市 高等院校	地名	多个
喀什地区 地区生产总值	数字+单位	单个
楚雄彝族自治州 现任领导	人名	多个
弗莱河 流域面积	数字+单位	单个
山东省 地区生产总值	数字+单位	单个
萍乡市 高等院校	地名	多个
锡林郭勒盟 现任领导	人名	多个
阿鲁巴 水域率	数字+单位	单个
圣萨尔瓦多 行政代码	数字	单个
黑河市 地区生产总值	数字+单位	单个
星湖 占地面积	数字+单位	单个
孟买 邮政区码	数字	单个
留尼汪岛 人口数量	数字+单位	单个
挪威海 海水温度	数字+单位	单个
克赖斯特彻奇 行政代码	数字	单个
武威市 现任领导	人名	多个
岷江 流域面积	数字+单位	单个
中山市 地区生产总值	数字+单位	单个
南京市 高等学府	地名	多个
瓦利斯和富图纳 官方语言	百科实体	单个
汉诺威 火车站	百科实体	多个
阿鲁巴 人均GDP	数字+单位	单个
台州市 地区生产总值	数字+单位	单个
濮阳市 地区生产总值	数字+单位	单个
比亚河 主要支流	百科实体	多个
托克劳 人口密度	数字+单位	单个
瓦利斯和富图纳 主要宗教	百科实体	多个
泸沽湖 开放时间	数字+单位	单个
咸阳市 地区生产总值	数字+单位	单个
夏洛特 机场	百科实体	单个
利亚德河 主要支流	百科实体	多个
槟城 行政代码	数字	单个
珠海市 高等院校	地名	多个
俄克拉荷马城 行政代码	数字	单个
辽阳市 高等院校	地名	多个
梁子湖 建议游玩时长	数字+单位	单个
鄱阳湖 开放时间	数字+单位	单个
吴如错 适宜游玩季节	数字+单位	单个
北美洲 国家和地区	数字+单位	单个
库里蒂巴 行政代码	数字	单个
杜塞尔多夫 下辖地区	数字+单位	多个
幼发拉底河 主要支流	百科实体	多个
奥胡斯 著名景点	百科实体	多个
悉尼 下辖地区	数字+单位	多个
绵阳市 地区生产总值	数字+单位	单个
中卫市 现任领导	人名	多个
南极洲 地理位置	百科实体	多个
科隆 邮政区码	数字	单个
北江 河流面积	数字+单位	单个
麦迪逊 面积	数字+单位	单个
陕西省 地区生产总值	数字+单位	单个
罗马 著名景点	百科实体	多个
北江 主要支流	百科实体	多个
沈阳市 现任领导	人名	多个
南充市 现任领导	人名	多个
奥马哈 著名景点	百科实体	多个
林茨 行政区类别	其他	单个
宽果河 所属水系	其他	单个
雅普拉河 中文名称	其他	单个
九龙江 地理位置	其他	单个
乌江 中文名称	其他	单个
和田河 所属水系	其他	单个
丹霞山国家级自然保护区 气候类型	其他	句子
大雪山 外文名	其他	多个
巴拉圭河 英文名称	其他	多个
石首麋鹿国家级自然保护区 中文名称	其他	句子
里加 政府驻地	其他	单个
乌卡亚利河 地理位置	其他	单个
马普托 外文名称	其他	单个
不莱梅 车牌代码	其他	单个
玛代拉河 外文名	其他	多个
突尼斯城 所属地区	其他	单个
开曼群岛 国家格言	其他	句子
几内亚比绍 最大城市	其他	单个
怀特河 中文名称	其他	单个
蒂华纳 别名	其他	多个
蒙特塞拉特 最大城市	其他	单个
阿尔金山国家级自然保护区 中文名称	其他	句子
克雷塔罗 气候条件	其他	句子
奥地利 国家格言	其他	句子
古巴 最大城市	其他	单个
安圭拉 简称	其他	单个
新德里 政府驻地	其他	单个
兴凯湖国家级自然保护区 中文名称	其他	句子
南渡河 外文名	其他	多个
辽宁仙人洞国家级自然保护区 级别	其他	单个
里加 别名	其他	多个
凉水国家级自然保护区 级别	其他	单个
阳明山国家级自然保护区 保护对象	其他	句子
多特蒙德 中文名称	其他	单个
哥德堡 气候条件	其他	句子
桑库鲁河 所属水系	其他	单个
湄公河 发源地	其他	句子
雾灵山国家级自然保护区 气候类型	其他	句子
挠力河国家级自然保护区 保护对象	其他	句子
雷公山国家级自然保护区 保护对象	其他	句子
伊利湖 所属国家	其他	多个
伊犁河 英文名称	其他	多个
渥太华河 发源地	其他	句子
乌特勒支 气候条件	其他	句子
昂孜错 外文名称	其他	多个
江西武夷山国家级自然保护区 级别	其他	单个
东非高原 外文名	其他	多个
大黑山国家级自然保护区 中文名称	其他	句子
檀香山 车牌代码	其他	单个
维尔霍扬斯克山脉 地理位置	其他	句子
莫桑比克 国家格言	其他	句子
东江 中文名称	其他	单个
安拉阿巴德 行政区类别	其他	单个
基多 气候条件	其他	句子
卑尔根 气候条件	其他	句子
帕米尔高原 地理位置	其他	句子
茅山山脉 地理位置	其他	句子
亚马逊河 英文名称	其他	多个
十万大山国家级自然保护区 地理位置	其他	句子
红岩河 英文名称	其他	多个
宿雾 所属地区	其他	单个
兴凯湖 著名景点	其他	多个
雅鲁藏布江中游河谷黑颈鹤国家级自然保护区 类型	其他	句子
哈坦加河 英文名称	其他	多个
阿雅克库木湖 地理位置	其他	句子
南岭国家级自然保护区 气候类型	其他	句子
阿克苏河 所属水系	其他	单个
芬利河 中文名称	其他	单个
麻阳河国家级自然保护区 级别	其他	单个
乍得湖 外文名	其他	多个
新奥尔良 别名	其他	多个
圣文森特和格林纳丁斯 最大城市	其他	单个
哈里斯堡 气候条件	其他	句子
萨格勒布 车牌代码	其他	单个
法罗群岛 所属洲	其他	单个
安拉阿巴德 别名	其他	多个
阿普里马克河 发源地	其他	句子
山旺古生物化石国家级自然保护区 保护对象	其他	句子
乌干达 最大城市	其他	单个
花萼山国家级自然保护区 气候类型	其他	句子
南安普顿 行政区类别	其他	单个
哈默斯利岭 中文名称	其他	单个
连城国家级自然保护区 保护对象	其他	句子
马尔马拉海 地理位置	其他	句子
澜沧江 外文名	其他	多个
塞皮克河 外文名	其他	多个
卢特沙漠 气候条件	其他	句子
圣克鲁斯 行政区类别	其他	单个
圣弗朗西斯科河 中文名称	其他	单个
阿拉伯河 中文名称	其他	单个
加那利群岛 国际电话区号	其他	单个
北德维纳河 英文名称	其他	多个
衡阳盆地 外文名	其他	多个
圣克莱尔河 地理位置	其他	单个
多特蒙德 气候条件	其他	句子
艾哈迈达巴德 气候条件	其他	句子
塞维利亚 地理位置	其他	句子
蒙得维的亚 别名	其他	多个
蒙特雷 车牌代码	其他	单个
里海 所属国家	其他	多个
