印度洋 最大水深	数字+单位	单个
印度洋 海区平均气温	百科实体	多个
印度洋 平均深度	数字+单位	单个
印度洋 平均盐度	数字+单位	单个
印度洋 主要资源	百科实体	多个
印度洋 海水温度	数字+单位	单个
印度洋 年平均降水量	数字+单位	单个
印度洋 最深处	百科实体	单个
印度洋 主要水体	百科实体	多个
印度洋 沿岸国家	百科实体	多个
印度洋 海岸线长度	数字+单位	单个
印度洋 平均水温	数字+单位	单个
印度洋 南北跨度	数字+单位	单个
印度洋 主要岛屿	百科实体	多个
印度洋 东西跨度	数字+单位	单个
印度洋 典型盐度	数字+单位	单个
印度洋 主要群岛	百科实体	多个
北冰洋 陆地来水量	数字+单位	单个
北冰洋 地理位置	百科实体	多个
北冰洋 含盐度	数字+单位	单个
北冰洋 平均深度	数字+单位	单个
北冰洋 年蒸发量	数字+单位	单个
北冰洋 平均盐度	数字+单位	单个
北冰洋 主要海峡	百科实体	多个
北冰洋 最大宽度	数字+单位	单个
北冰洋 海水温度	数字+单位	单个
北冰洋 最深处	百科实体	单个
北冰洋 气候类型	其他	多个
北冰洋 平均水温	数字+单位	单个
北冰洋 周边国家	百科实体	多个
北冰洋 别称	其他	句子
北冰洋 最深点	其他	句子
北冰洋 年交换量	数字+单位	单个
太平洋 陆地来水量	数字+单位	单个
太平洋 地理位置	百科实体	多个
太平洋 最大水深	数字+单位	单个
太平洋 含盐度	数字+单位	单个
太平洋 海区平均气温	百科实体	多个
太平洋 年蒸发量	数字+单位	单个
太平洋 主要海峡	百科实体	多个
太平洋 主要资源	百科实体	多个
太平洋 海岸线	数字+单位	单个
太平洋 最大宽度	数字+单位	单个
太平洋 年平均降水量	数字+单位	单个
太平洋 主要水体	百科实体	多个
太平洋 海岸线长度	数字+单位	单个
太平洋 平均水温	数字+单位	单个
太平洋 周边国家	百科实体	多个
太平洋 别称	其他	句子
太平洋 海岸线长	数字+单位	单个
太平洋 平均水深	数字+单位	单个
太平洋 南北跨度	数字+单位	单个
太平洋 主要岛屿	百科实体	多个
太平洋 东西跨度	数字+单位	单个
太平洋 典型盐度	数字+单位	单个
太平洋 最深点	其他	句子
太平洋 年交换量	数字+单位	单个
太平洋 主要群岛	百科实体	多个
大西洋 陆地来水量	数字+单位	单个
大西洋 地理位置	百科实体	多个
大西洋 最大水深	数字+单位	单个
大西洋 含盐度	数字+单位	单个
大西洋 海区平均气温	百科实体	多个
大西洋 年蒸发量	数字+单位	单个
大西洋 主要海峡	百科实体	多个
大西洋 主要资源	百科实体	多个
大西洋 海岸线	数字+单位	单个
大西洋 最大宽度	数字+单位	单个
大西洋 海水温度	数字+单位	单个
大西洋 年平均降水量	数字+单位	单个
大西洋 主要水体	百科实体	多个
大西洋 海岸线长度	数字+单位	单个
大西洋 气候类型	其他	多个
大西洋 周边国家	百科实体	多个
大西洋 别称	其他	句子
大西洋 海岸线长	数字+单位	单个
大西洋 平均水深	数字+单位	单个
大西洋 南北跨度	数字+单位	单个
大西洋 主要岛屿	百科实体	多个
大西洋 东西跨度	数字+单位	单个
大西洋 典型盐度	数字+单位	单个
大西洋 最深点	其他	句子
大西洋 年交换量	数字+单位	单个
大西洋 主要群岛	百科实体	多个
