亚洲 著名景点	百科实体	多个
亚洲 方言	百科实体	多个
大洋洲 本义	其他	句子
大洋洲 语言	地名	多个
大洋洲 意译	其他	单个
大洋洲 国家和地区	数字+单位	单个
南美洲 本义	其他	句子
南美洲 下辖地区	百科实体	多个
南美洲 意译	其他	单个
南美洲 地理位置	百科实体	多个
南美洲 国家和地区	数字+单位	单个
南美洲 方言	百科实体	多个
欧洲 语言	地名	多个
欧洲 著名景点	百科实体	多个
欧洲 地理位置	百科实体	多个
欧洲 主要国家	百科实体	多个
非洲 国家和地区	数字+单位	单个
非洲 方言	百科实体	多个
北美洲 行政区类别	其他	单个
北美洲 本义	其他	句子
北美洲 气候条件	百科实体	多个
北美洲 下辖地区	百科实体	多个
北美洲 意译	其他	单个
北美洲 著名景点	百科实体	多个
北美洲 别名	其他	单个
北美洲 地理位置	百科实体	多个
北美洲 国家和地区	数字+单位	单个
北美洲 方言	百科实体	多个
北美洲 中文名称	其他	单个
北美洲 外文名称	其他	单个
南极洲 行政区类别	其他	单个
南极洲 本义	其他	句子
南极洲 气候条件	百科实体	多个
南极洲 语言	地名	多个
南极洲 下辖地区	百科实体	多个
南极洲 意译	其他	单个
南极洲 著名景点	百科实体	多个
南极洲 人口密度	数字+单位	单个
南极洲 别名	其他	单个
南极洲 地理位置	百科实体	多个
南极洲 国家和地区	数字+单位	单个
南极洲 人口	数字+单位	单个
南极洲 主要国家	百科实体	多个
南极洲 方言	百科实体	多个
南极洲 中文名称	其他	单个
南极洲 外文名称	其他	单个
