中西伯利亚高原 海拔	数字+单位	单个
中西伯利亚高原 平均海拔	数字+单位	单个
中西伯利亚高原 地理位置	其他	句子
中西伯利亚高原 面积	数字+单位	单个
加丹加高原 外文名	其他	多个
加丹加高原 平均海拔	数字+单位	单个
加丹加高原 地理位置	其他	句子
加丹加高原 面积	数字+单位	单个
南非高原 平均海拔	数字+单位	单个
南非高原 地理位置	其他	句子
东非高原 外文名	其他	多个
东非高原 地理位置	其他	句子
盖马高原 面积	数字+单位	单个
阿哈加尔高原 平均海拔	数字+单位	单个
阿哈加尔高原 面积	数字+单位	单个
陕北高原 海拔	数字+单位	单个
陕北高原 平均海拔	数字+单位	单个
陕北高原 地理位置	其他	句子
川西高原 平均海拔	数字+单位	单个
墨西哥高原 地理位置	其他	句子
帕米尔高原 地理位置	其他	句子
帕米尔高原 面积	数字+单位	单个
提贝斯提高原 外文名	其他	多个
提贝斯提高原 海拔	数字+单位	单个
提贝斯提高原 平均海拔	数字+单位	单个
提贝斯提高原 地理位置	其他	句子
提贝斯提高原 面积	数字+单位	单个
青藏高原 平均海拔	数字+单位	单个
青藏高原 地理位置	其他	句子
伊朗高原 海拔	数字+单位	单个
伊朗高原 平均海拔	数字+单位	单个
伊朗高原 面积	数字+单位	单个
鄂尔多斯高原 平均海拔	数字+单位	单个
巴塔哥尼亚高原 海拔	数字+单位	单个
巴塔哥尼亚高原 平均海拔	数字+单位	单个
云贵高原 平均海拔	数字+单位	单个
阿拉善高原 地理位置	其他	句子
玻利维亚高原 外文名	其他	多个
玻利维亚高原 海拔	数字+单位	单个
玻利维亚高原 平均海拔	数字+单位	单个
玻利维亚高原 地理位置	其他	句子
科罗拉多高原 平均海拔	数字+单位	单个
德干高原 平均海拔	数字+单位	单个
德干高原 地理位置	其他	句子
德干高原 面积	数字+单位	单个
巴西高原 海拔	数字+单位	单个
巴西高原 平均海拔	数字+单位	单个
巴西高原 地理位置	其他	句子
滇中高原 外文名	其他	多个
滇中高原 海拔	数字+单位	单个
滇中高原 平均海拔	数字+单位	单个
滇中高原 地理位置	其他	句子
滇中高原 面积	数字+单位	单个
圭亚那高原 海拔	数字+单位	单个
圭亚那高原 平均海拔	数字+单位	单个
圭亚那高原 地理位置	其他	句子
圭亚那高原 面积	数字+单位	单个
呼伦贝尔高原 外文名	其他	多个
呼伦贝尔高原 平均海拔	数字+单位	单个
呼伦贝尔高原 地理位置	其他	句子
呼伦贝尔高原 面积	数字+单位	单个
埃塞俄比亚高原 外文名	其他	多个
内蒙古高原 平均海拔	数字+单位	单个
内蒙古高原 地理位置	其他	句子
隆达高原 外文名	其他	多个
隆达高原 平均海拔	数字+单位	单个
隆达高原 地理位置	其他	句子
隆达高原 面积	数字+单位	单个
安纳托利亚高原 平均海拔	数字+单位	单个
安纳托利亚高原 地理位置	其他	句子
安纳托利亚高原 面积	数字+单位	单个
金伯利高原 海拔	数字+单位	单个
金伯利高原 平均海拔	数字+单位	单个
金伯利高原 地理位置	其他	句子
金伯利高原 面积	数字+单位	单个
蒙古高原 地理位置	其他	句子
蒙古高原 面积	数字+单位	单个
黄土高原 海拔	数字+单位	单个
黄土高原 平均海拔	数字+单位	单个
南极高原 外文名	其他	多个
南极高原 地理位置	其他	句子
南极高原 面积	数字+单位	单个
阿拉伯高原 外文名	其他	多个
阿拉伯高原 平均海拔	数字+单位	单个
阿拉伯高原 地理位置	其他	句子
巴伐利亚高原 外文名	其他	多个
巴伐利亚高原 面积	数字+单位	单个
澳大利亚西部高原 海拔	数字+单位	单个
澳大利亚西部高原 平均海拔	数字+单位	单个
藏北高原 外文名	其他	多个
藏北高原 海拔	数字+单位	单个
藏北高原 平均海拔	数字+单位	单个
贵州高原 地理位置	其他	句子
贵州高原 面积	数字+单位	单个
亚美尼亚高原 地理位置	其他	句子
阿里高原 外文名	其他	多个
阿里高原 海拔	数字+单位	单个
阿里高原 平均海拔	数字+单位	单个
阿里高原 地理位置	其他	句子
哈当厄高原 海拔	数字+单位	单个
哈当厄高原 平均海拔	数字+单位	单个
哈当厄高原 地理位置	其他	句子
哈当厄高原 面积	数字+单位	单个
特兰西瓦尼亚高原 外文名	其他	多个
特兰西瓦尼亚高原 平均海拔	数字+单位	单个
特兰西瓦尼亚高原 地理位置	其他	句子
特兰西瓦尼亚高原 面积	数字+单位	单个
