泰国 最大城市	其他	单个
巴西 国家格言	其他	句子
斯威士兰 最大城市	其他	单个
斯威士兰 主要城市	百科实体	多个
斯威士兰 国花	百科实体	单个
斯威士兰 国歌	百科实体	句子
安道尔 主要学府	其他	多个
安道尔 国花	百科实体	单个
委内瑞拉 最大城市	其他	单个
委内瑞拉 国花	百科实体	单个
委内瑞拉 国家格言	其他	句子
留尼汪岛 时区	其他	句子
留尼汪岛 国家领袖	人名	多个
留尼汪岛 首都	地名	单个
留尼汪岛 政治体制	其他	句子
留尼汪岛 国际域名缩写	其他	单个
留尼汪岛 人类发展指数	数字	单个
留尼汪岛 最大城市	其他	单个
留尼汪岛 简称	其他	单个
留尼汪岛 主要学府	其他	多个
留尼汪岛 主要城市	百科实体	多个
留尼汪岛 国庆日	数字+单位	单个
留尼汪岛 主要民族	百科实体	多个
留尼汪岛 国土面积	数字+单位	单个
留尼汪岛 水域率	数字+单位	单个
留尼汪岛 人均GDP	数字+单位	单个
留尼汪岛 国际电话区号	其他	单个
留尼汪岛 国花	百科实体	单个
留尼汪岛 国家代码	其他	单个
留尼汪岛 人口数量	数字+单位	单个
留尼汪岛 所属洲	其他	单个
留尼汪岛 货币	百科实体	单个
留尼汪岛 国家格言	其他	句子
留尼汪岛 道路通行	其他	单个
留尼汪岛 英文名称	其他	多个
留尼汪岛 国歌	百科实体	句子
约旦 水域率	数字+单位	单个
新西兰 简称	其他	单个
新西兰 国家格言	其他	句子
柬埔寨 国家格言	其他	句子
布隆迪 水域率	数字+单位	单个
布隆迪 国花	百科实体	单个
贝宁 水域率	数字+单位	单个
贝宁 国花	百科实体	单个
贝宁 国家格言	其他	句子
加纳 国花	百科实体	单个
加纳 国家格言	其他	句子
科特迪瓦 最大城市	其他	单个
科特迪瓦 国花	百科实体	单个
科特迪瓦 国家格言	其他	句子
直布罗陀 国家领袖	人名	多个
直布罗陀 首都	地名	单个
直布罗陀 政治体制	其他	句子
直布罗陀 国际域名缩写	其他	单个
直布罗陀 主要宗教	百科实体	多个
直布罗陀 人类发展指数	数字	单个
直布罗陀 最大城市	其他	单个
直布罗陀 简称	其他	单个
直布罗陀 主要学府	其他	多个
直布罗陀 主要城市	百科实体	多个
直布罗陀 国庆日	数字+单位	单个
直布罗陀 主要民族	百科实体	多个
直布罗陀 人口密度	数字+单位	单个
直布罗陀 国土面积	数字+单位	单个
直布罗陀 水域率	数字+单位	单个
直布罗陀 国际电话区号	其他	单个
直布罗陀 国花	百科实体	单个
直布罗陀 国家代码	其他	单个
直布罗陀 人口数量	数字+单位	单个
直布罗陀 官方语言	百科实体	单个
直布罗陀 所属洲	其他	单个
直布罗陀 国家格言	其他	句子
直布罗陀 道路通行	其他	单个
直布罗陀 英文名称	其他	多个
直布罗陀 国歌	百科实体	句子
挪威 国家格言	其他	句子
阿根廷 最大城市	其他	单个
纳米比亚 国花	百科实体	单个
特立尼达和多巴哥 人类发展指数	数字	单个
特立尼达和多巴哥 最大城市	其他	单个
特立尼达和多巴哥 水域率	数字+单位	单个
特立尼达和多巴哥 国花	百科实体	单个
特立尼达和多巴哥 国家格言	其他	句子
库拉索 时区	其他	句子
库拉索 国家领袖	人名	多个
库拉索 首都	地名	单个
库拉索 政治体制	其他	句子
库拉索 国际域名缩写	其他	单个
库拉索 主要宗教	百科实体	多个
库拉索 人类发展指数	数字	单个
库拉索 最大城市	其他	单个
库拉索 简称	其他	单个
库拉索 主要学府	其他	多个
库拉索 主要城市	百科实体	多个
库拉索 国庆日	数字+单位	单个
库拉索 主要民族	百科实体	多个
库拉索 人口密度	数字+单位	单个
库拉索 国土面积	数字+单位	单个
库拉索 中文名称	其他	句子
库拉索 GDP总计	数字+单位	单个
库拉索 水域率	数字+单位	单个
库拉索 人均GDP	数字+单位	单个
库拉索 国际电话区号	其他	单个
库拉索 国花	百科实体	单个
库拉索 国家代码	其他	单个
库拉索 人口数量	数字+单位	单个
库拉索 官方语言	百科实体	单个
库拉索 所属洲	其他	单个
库拉索 货币	百科实体	单个
库拉索 国家格言	其他	句子
库拉索 道路通行	其他	单个
库拉索 英文名称	其他	多个
库拉索 国歌	百科实体	句子
东帝汶 人类发展指数	数字	单个
东帝汶 最大城市	其他	单个
东帝汶 水域率	数字+单位	单个
东帝汶 国花	百科实体	单个
东帝汶 国家格言	其他	句子
乌兹别克斯坦 最大城市	其他	单个
乌兹别克斯坦 国花	百科实体	单个
乌兹别克斯坦 国家格言	其他	句子
卡塔尔 最大城市	其他	单个
卡塔尔 主要城市	百科实体	多个
卡塔尔 水域率	数字+单位	单个
卡塔尔 国花	百科实体	单个
卡塔尔 国家格言	其他	句子
马绍尔群岛 人类发展指数	数字	单个
马绍尔群岛 主要学府	其他	多个
马绍尔群岛 水域率	数字+单位	单个
马绍尔群岛 国花	百科实体	单个
马绍尔群岛 国家格言	其他	句子
巴林 人类发展指数	数字	单个
巴林 最大城市	其他	单个
巴林 主要城市	百科实体	多个
巴林 水域率	数字+单位	单个
巴林 国花	百科实体	单个
巴林 国家格言	其他	句子
哥伦比亚 国花	百科实体	单个
哥伦比亚 道路通行	其他	单个
德国 国花	百科实体	单个
德国 国家格言	其他	句子
马耳他 国际域名缩写	其他	单个
马耳他 人类发展指数	数字	单个
马耳他 最大城市	其他	单个
马耳他 主要城市	百科实体	多个
马耳他 国际电话区号	其他	单个
马耳他 国家格言	其他	句子
英国 主要学府	其他	多个
圣文森特和格林纳丁斯 人类发展指数	数字	单个
圣文森特和格林纳丁斯 最大城市	其他	单个
圣文森特和格林纳丁斯 简称	其他	单个
圣文森特和格林纳丁斯 主要学府	其他	多个
圣文森特和格林纳丁斯 主要城市	百科实体	多个
圣文森特和格林纳丁斯 水域率	数字+单位	单个
圣文森特和格林纳丁斯 国花	百科实体	单个
圣文森特和格林纳丁斯 国家格言	其他	句子
所罗门群岛 人类发展指数	数字	单个
所罗门群岛 最大城市	其他	单个
所罗门群岛 简称	其他	单个
所罗门群岛 主要学府	其他	多个
所罗门群岛 国花	百科实体	单个
所罗门群岛 国家格言	其他	句子
瑞士 国家格言	其他	句子
奥地利 人类发展指数	数字	单个
奥地利 国家格言	其他	句子
马尔代夫 最大城市	其他	单个
马尔代夫 主要城市	百科实体	多个
马尔代夫 水域率	数字+单位	单个
马尔代夫 国家格言	其他	句子
加蓬 国花	百科实体	单个
意大利 人类发展指数	数字	单个
意大利 国花	百科实体	单个
意大利 国家格言	其他	句子
刚果民主共和国 国花	百科实体	单个
科摩罗 人类发展指数	数字	单个
科摩罗 最大城市	其他	单个
科摩罗 国花	百科实体	单个
科摩罗 国家格言	其他	句子
马德拉群岛 时区	其他	句子
马德拉群岛 国家领袖	人名	多个
马德拉群岛 首都	地名	单个
马德拉群岛 政治体制	其他	句子
马德拉群岛 国际域名缩写	其他	单个
马德拉群岛 主要宗教	百科实体	多个
马德拉群岛 人类发展指数	数字	单个
马德拉群岛 最大城市	其他	单个
马德拉群岛 简称	其他	单个
马德拉群岛 主要学府	其他	多个
马德拉群岛 主要城市	百科实体	多个
马德拉群岛 国庆日	数字+单位	单个
马德拉群岛 主要民族	百科实体	多个
马德拉群岛 人口密度	数字+单位	单个
马德拉群岛 国土面积	数字+单位	单个
马德拉群岛 中文名称	其他	句子
马德拉群岛 GDP总计	数字+单位	单个
马德拉群岛 水域率	数字+单位	单个
马德拉群岛 人均GDP	数字+单位	单个
马德拉群岛 国际电话区号	其他	单个
马德拉群岛 国花	百科实体	单个
马德拉群岛 国家代码	其他	单个
马德拉群岛 人口数量	数字+单位	单个
马德拉群岛 官方语言	百科实体	单个
马德拉群岛 所属洲	其他	单个
马德拉群岛 货币	百科实体	单个
马德拉群岛 国家格言	其他	句子
马德拉群岛 道路通行	其他	单个
马德拉群岛 英文名称	其他	多个
马德拉群岛 国歌	百科实体	句子
瓦努阿图 最大城市	其他	单个
瓦努阿图 水域率	数字+单位	单个
瓦努阿图 国花	百科实体	单个
土耳其 最大城市	其他	单个
土耳其 国花	百科实体	单个
芬兰 人类发展指数	数字	单个
芬兰 最大城市	其他	单个
芬兰 国花	百科实体	单个
芬兰 国家格言	其他	句子
阿鲁巴 时区	其他	句子
阿鲁巴 国家领袖	人名	多个
阿鲁巴 首都	地名	单个
阿鲁巴 政治体制	其他	句子
阿鲁巴 国际域名缩写	其他	单个
阿鲁巴 主要宗教	百科实体	多个
阿鲁巴 人类发展指数	数字	单个
阿鲁巴 最大城市	其他	单个
阿鲁巴 简称	其他	单个
阿鲁巴 主要学府	其他	多个
阿鲁巴 主要城市	百科实体	多个
阿鲁巴 国庆日	数字+单位	单个
阿鲁巴 主要民族	百科实体	多个
阿鲁巴 人口密度	数字+单位	单个
阿鲁巴 国土面积	数字+单位	单个
阿鲁巴 中文名称	其他	句子
阿鲁巴 GDP总计	数字+单位	单个
阿鲁巴 水域率	数字+单位	单个
阿鲁巴 人均GDP	数字+单位	单个
阿鲁巴 国际电话区号	其他	单个
阿鲁巴 国花	百科实体	单个
阿鲁巴 国家代码	其他	单个
阿鲁巴 人口数量	数字+单位	单个
阿鲁巴 官方语言	百科实体	单个
阿鲁巴 所属洲	其他	单个
阿鲁巴 货币	百科实体	单个
阿鲁巴 国家格言	其他	句子
阿鲁巴 道路通行	其他	单个
阿鲁巴 英文名称	其他	多个
阿鲁巴 国歌	百科实体	句子
托克劳 时区	其他	句子
托克劳 国家领袖	人名	多个
托克劳 首都	地名	单个
托克劳 政治体制	其他	句子
托克劳 国际域名缩写	其他	单个
托克劳 主要宗教	百科实体	多个
托克劳 人类发展指数	数字	单个
托克劳 最大城市	其他	单个
托克劳 简称	其他	单个
托克劳 主要城市	百科实体	多个
托克劳 国庆日	数字+单位	单个
托克劳 主要民族	百科实体	多个
托克劳 人口密度	数字+单位	单个
托克劳 国土面积	数字+单位	单个
托克劳 GDP总计	数字+单位	单个
托克劳 水域率	数字+单位	单个
托克劳 人均GDP	数字+单位	单个
托克劳 国际电话区号	其他	单个
托克劳 国花	百科实体	单个
托克劳 国家代码	其他	单个
托克劳 人口数量	数字+单位	单个
托克劳 官方语言	百科实体	单个
托克劳 货币	百科实体	单个
托克劳 国家格言	其他	句子
托克劳 道路通行	其他	单个
托克劳 英文名称	其他	多个
托克劳 国歌	百科实体	句子
比利时 国家格言	其他	句子
斐济群岛 人类发展指数	数字	单个
斐济群岛 最大城市	其他	单个
斐济群岛 水域率	数字+单位	单个
斐济群岛 国花	百科实体	单个
斐济群岛 国家格言	其他	句子
密克罗尼西亚联邦 人类发展指数	数字	单个
密克罗尼西亚联邦 最大城市	其他	单个
密克罗尼西亚联邦 主要学府	其他	多个
密克罗尼西亚联邦 水域率	数字+单位	单个
密克罗尼西亚联邦 国花	百科实体	单个
密克罗尼西亚联邦 国家格言	其他	句子
刚果共和国 人类发展指数	数字	单个
刚果共和国 最大城市	其他	单个
刚果共和国 国花	百科实体	单个
刚果共和国 国家格言	其他	句子
索马里 人类发展指数	数字	单个
索马里 最大城市	其他	单个
索马里 水域率	数字+单位	单个
索马里 国花	百科实体	单个
索马里 国家格言	其他	句子
埃及 最大城市	其他	单个
埃及 国家格言	其他	句子
利比亚 水域率	数字+单位	单个
利比亚 国家格言	其他	句子
叙利亚 人类发展指数	数字	单个
叙利亚 最大城市	其他	单个
叙利亚 国家格言	其他	句子
巴巴多斯 最大城市	其他	单个
巴巴多斯 简称	其他	单个
巴巴多斯 水域率	数字+单位	单个
多米尼加共和国 主要学府	其他	多个
多米尼加共和国 国花	百科实体	单个
阿尔巴尼亚 国花	百科实体	单个
阿尔巴尼亚 国家格言	其他	句子
中国 国家领袖	人名	多个
中国 人类发展指数	数字	单个
中国 最大城市	其他	单个
中国 主要学府	其他	多个
中国 主要城市	百科实体	多个
中国 国庆日	数字+单位	单个
中国 人口密度	数字+单位	单个
中国 GDP总计	数字+单位	单个
中国 水域率	数字+单位	单个
中国 人均GDP	数字+单位	单个
中国 国花	百科实体	单个
中国 国家代码	其他	单个
中国 人口数量	数字+单位	单个
中国 国家格言	其他	句子
澳大利亚 最大城市	其他	单个
澳大利亚 国花	百科实体	单个
澳大利亚 国家格言	其他	句子
蒙古 最大城市	其他	单个
蒙古 国花	百科实体	单个
蒙古 国家格言	其他	句子
佛得角 水域率	数字+单位	单个
佛得角 国花	百科实体	单个
佛得角 国家格言	其他	句子
萨摩亚 人类发展指数	数字	单个
萨摩亚 最大城市	其他	单个
萨摩亚 国家格言	其他	句子
巴勒斯坦 人类发展指数	数字	单个
巴勒斯坦 最大城市	其他	单个
巴勒斯坦 国花	百科实体	单个
巴勒斯坦 国家格言	其他	句子
赤道几内亚 主要学府	其他	多个
赤道几内亚 水域率	数字+单位	单个
赤道几内亚 国花	百科实体	单个
阿曼 人类发展指数	数字	单个
阿曼 最大城市	其他	单个
阿曼 水域率	数字+单位	单个
阿曼 国花	百科实体	单个
阿曼 国家格言	其他	句子
北马里亚纳 时区	其他	句子
北马里亚纳 国家领袖	人名	多个
北马里亚纳 首都	地名	单个
北马里亚纳 政治体制	其他	句子
北马里亚纳 国际域名缩写	其他	单个
北马里亚纳 主要宗教	百科实体	多个
北马里亚纳 人类发展指数	数字	单个
北马里亚纳 最大城市	其他	单个
北马里亚纳 简称	其他	单个
北马里亚纳 主要学府	其他	多个
北马里亚纳 主要城市	百科实体	多个
北马里亚纳 国庆日	数字+单位	单个
北马里亚纳 主要民族	百科实体	多个
北马里亚纳 国土面积	数字+单位	单个
北马里亚纳 水域率	数字+单位	单个
北马里亚纳 国际电话区号	其他	单个
北马里亚纳 国花	百科实体	单个
北马里亚纳 国家代码	其他	单个
北马里亚纳 人口数量	数字+单位	单个
北马里亚纳 官方语言	百科实体	单个
北马里亚纳 所属洲	其他	单个
北马里亚纳 国家格言	其他	句子
北马里亚纳 道路通行	其他	单个
北马里亚纳 英文名称	其他	多个
北马里亚纳 国歌	百科实体	句子
海地 人类发展指数	数字	单个
海地 最大城市	其他	单个
海地 国花	百科实体	单个
海地 国家格言	其他	句子
古巴 最大城市	其他	单个
古巴 水域率	数字+单位	单个
古巴 国花	百科实体	单个
古巴 国家格言	其他	句子
黎巴嫩 国花	百科实体	单个
黎巴嫩 国家格言	其他	句子
法属圭亚那 时区	其他	句子
法属圭亚那 国家领袖	人名	多个
法属圭亚那 首都	地名	单个
法属圭亚那 政治体制	其他	句子
法属圭亚那 国际域名缩写	其他	单个
法属圭亚那 主要宗教	百科实体	多个
法属圭亚那 人类发展指数	数字	单个
法属圭亚那 最大城市	其他	单个
法属圭亚那 简称	其他	单个
法属圭亚那 主要学府	其他	多个
法属圭亚那 主要城市	百科实体	多个
法属圭亚那 国庆日	数字+单位	单个
法属圭亚那 主要民族	百科实体	多个
法属圭亚那 人口密度	数字+单位	单个
法属圭亚那 国土面积	数字+单位	单个
法属圭亚那 GDP总计	数字+单位	单个
法属圭亚那 水域率	数字+单位	单个
法属圭亚那 人均GDP	数字+单位	单个
法属圭亚那 国际电话区号	其他	单个
法属圭亚那 国花	百科实体	单个
法属圭亚那 国家代码	其他	单个
法属圭亚那 人口数量	数字+单位	单个
法属圭亚那 官方语言	百科实体	单个
法属圭亚那 所属洲	其他	单个
法属圭亚那 国家格言	其他	句子
法属圭亚那 道路通行	其他	单个
法属圭亚那 英文名称	其他	多个
法属圭亚那 国歌	百科实体	句子
尼泊尔 最大城市	其他	单个
尼泊尔 国家格言	其他	句子
罗马尼亚 人类发展指数	数字	单个
罗马尼亚 简称	其他	单个
罗马尼亚 国家格言	其他	句子
卢旺达 人类发展指数	数字	单个
卢旺达 最大城市	其他	单个
卢旺达 国花	百科实体	单个
卢旺达 国家格言	其他	句子
几内亚 人类发展指数	数字	单个
几内亚 最大城市	其他	单个
几内亚 水域率	数字+单位	单个
几内亚 国花	百科实体	单个
几内亚 国家格言	其他	句子
纽埃 人类发展指数	数字	单个
纽埃 最大城市	其他	单个
纽埃 主要学府	其他	多个
纽埃 水域率	数字+单位	单个
纽埃 国花	百科实体	单个
纽埃 国家格言	其他	句子
安哥拉 最大城市	其他	单个
安哥拉 国花	百科实体	单个
安哥拉 国家格言	其他	句子
吉布提 人类发展指数	数字	单个
吉布提 最大城市	其他	单个
吉布提 国花	百科实体	单个
吉布提 国家格言	其他	句子
库克群岛 人类发展指数	数字	单个
库克群岛 最大城市	其他	单个
库克群岛 简称	其他	单个
库克群岛 水域率	数字+单位	单个
库克群岛 国花	百科实体	单个
库克群岛 国家格言	其他	句子
汤加 人类发展指数	数字	单个
汤加 最大城市	其他	单个
汤加 主要城市	百科实体	多个
汤加 国花	百科实体	单个
汤加 国家格言	其他	句子
以色列 国家格言	其他	句子
开曼群岛 国家领袖	人名	多个
开曼群岛 人类发展指数	数字	单个
开曼群岛 简称	其他	单个
开曼群岛 国庆日	数字+单位	单个
开曼群岛 国花	百科实体	单个
开曼群岛 国家格言	其他	句子
墨西哥 国家格言	其他	句子
危地马拉 最大城市	其他	单个
阿富汗 水域率	数字+单位	单个
阿富汗 国家格言	其他	句子
希腊 最大城市	其他	单个
希腊 水域率	数字+单位	单个
亚美尼亚 人类发展指数	数字	单个
亚美尼亚 国花	百科实体	单个
亚美尼亚 国家格言	其他	句子
多米尼克 国花	百科实体	单个
百慕大 时区	其他	句子
百慕大 国家领袖	人名	多个
百慕大 首都	地名	单个
百慕大 政治体制	其他	句子
百慕大 主要宗教	百科实体	多个
百慕大 人类发展指数	数字	单个
百慕大 最大城市	其他	单个
百慕大 简称	其他	单个
百慕大 主要学府	其他	多个
百慕大 主要城市	百科实体	多个
百慕大 国庆日	数字+单位	单个
百慕大 主要民族	百科实体	多个
百慕大 人口密度	数字+单位	单个
百慕大 国土面积	数字+单位	单个
百慕大 GDP总计	数字+单位	单个
百慕大 水域率	数字+单位	单个
百慕大 人均GDP	数字+单位	单个
百慕大 国际电话区号	其他	单个
百慕大 国花	百科实体	单个
百慕大 国家代码	其他	单个
百慕大 人口数量	数字+单位	单个
百慕大 官方语言	百科实体	单个
百慕大 所属洲	其他	单个
百慕大 道路通行	其他	单个
百慕大 英文名称	其他	多个
百慕大 国歌	百科实体	句子
新喀里多尼亚 人类发展指数	数字	单个
新喀里多尼亚 最大城市	其他	单个
新喀里多尼亚 主要学府	其他	多个
新喀里多尼亚 国庆日	数字+单位	单个
新喀里多尼亚 国花	百科实体	单个
新喀里多尼亚 国家格言	其他	句子
新喀里多尼亚 英文名称	其他	多个
新喀里多尼亚 国歌	百科实体	句子
保加利亚 国家格言	其他	句子
匈牙利 简称	其他	单个
匈牙利 国家格言	其他	句子
波兰 最大城市	其他	单个
波兰 国家格言	其他	句子
俄罗斯 最大城市	其他	单个
俄罗斯 主要学府	其他	多个
俄罗斯 国家格言	其他	句子
斯里兰卡 人类发展指数	数字	单个
斯里兰卡 最大城市	其他	单个
斯里兰卡 水域率	数字+单位	单个
斯里兰卡 国家格言	其他	句子
荷兰 人类发展指数	数字	单个
荷兰 国家格言	其他	句子
斯洛文尼亚 国花	百科实体	单个
斯洛文尼亚 国家格言	其他	句子
瑞典 最大城市	其他	单个
瑞典 主要学府	其他	多个
瑞典 国家格言	其他	句子
中非 人类发展指数	数字	单个
中非 最大城市	其他	单个
中非 水域率	数字+单位	单个
中非 国花	百科实体	单个
中非 国家格言	其他	句子
缅甸 人类发展指数	数字	单个
缅甸 国花	百科实体	单个
缅甸 国家格言	其他	句子
基里巴斯 主要学府	其他	多个
基里巴斯 水域率	数字+单位	单个
基里巴斯 国花	百科实体	单个
冰岛 国家格言	其他	句子
智利 国花	百科实体	单个
乍得 人类发展指数	数字	单个
乍得 最大城市	其他	单个
乍得 水域率	数字+单位	单个
乍得 国花	百科实体	单个
乍得 国家格言	其他	句子
突尼斯 人类发展指数	数字	单个
突尼斯 最大城市	其他	单个
突尼斯 国花	百科实体	单个
突尼斯 国家格言	其他	句子
马拉维 人类发展指数	数字	单个
马拉维 最大城市	其他	单个
马拉维 国花	百科实体	单个
马拉维 国家格言	其他	句子
巴布亚新几内亚 人类发展指数	数字	单个
巴布亚新几内亚 最大城市	其他	单个
巴布亚新几内亚 水域率	数字+单位	单个
巴布亚新几内亚 国花	百科实体	单个
巴布亚新几内亚 国家格言	其他	句子
伯利兹 人类发展指数	数字	单个
伯利兹 最大城市	其他	单个
伯利兹 简称	其他	单个
伯利兹 国花	百科实体	单个
伯利兹 国家格言	其他	句子
南非 水域率	数字+单位	单个
南非 国家格言	其他	句子
圣多美和普林西比 人类发展指数	数字	单个
圣多美和普林西比 最大城市	其他	单个
圣多美和普林西比 水域率	数字+单位	单个
圣多美和普林西比 国花	百科实体	单个
圣多美和普林西比 国家格言	其他	句子
马来西亚 最大城市	其他	单个
马来西亚 主要学府	其他	多个
马里 国花	百科实体	单个
巴哈马 最大城市	其他	单个
巴哈马 国花	百科实体	单个
葡萄牙 最大城市	其他	单个
葡萄牙 国家格言	其他	句子
津巴布韦 人类发展指数	数字	单个
津巴布韦 最大城市	其他	单个
津巴布韦 国花	百科实体	单个
津巴布韦 国家格言	其他	句子
孟加拉国 最大城市	其他	单个
孟加拉国 国家格言	其他	句子
菲律宾 最大城市	其他	单个
菲律宾 国家格言	其他	句子
多哥 人类发展指数	数字	单个
多哥 最大城市	其他	单个
多哥 主要学府	其他	多个
多哥 主要城市	百科实体	多个
多哥 国花	百科实体	单个
多哥 国家格言	其他	句子
赞比亚 人类发展指数	数字	单个
赞比亚 最大城市	其他	单个
赞比亚 国花	百科实体	单个
赞比亚 国家格言	其他	句子
瓜德罗普 时区	其他	句子
瓜德罗普 国家领袖	人名	多个
瓜德罗普 首都	地名	单个
瓜德罗普 政治体制	其他	句子
瓜德罗普 国际域名缩写	其他	单个
瓜德罗普 主要宗教	百科实体	多个
瓜德罗普 人类发展指数	数字	单个
瓜德罗普 最大城市	其他	单个
瓜德罗普 简称	其他	单个
瓜德罗普 主要学府	其他	多个
瓜德罗普 主要城市	百科实体	多个
瓜德罗普 国庆日	数字+单位	单个
瓜德罗普 主要民族	百科实体	多个
瓜德罗普 人口密度	数字+单位	单个
瓜德罗普 国土面积	数字+单位	单个
瓜德罗普 GDP总计	数字+单位	单个
瓜德罗普 水域率	数字+单位	单个
瓜德罗普 人均GDP	数字+单位	单个
瓜德罗普 国际电话区号	其他	单个
瓜德罗普 国花	百科实体	单个
瓜德罗普 国家代码	其他	单个
瓜德罗普 人口数量	数字+单位	单个
瓜德罗普 官方语言	百科实体	单个
瓜德罗普 所属洲	其他	单个
瓜德罗普 国家格言	其他	句子
瓜德罗普 道路通行	其他	单个
瓜德罗普 英文名称	其他	多个
瓜德罗普 国歌	百科实体	句子
文莱 国花	百科实体	单个
克罗地亚 国家格言	其他	句子
尼日利亚 人类发展指数	数字	单个
尼日利亚 国花	百科实体	单个
尼日利亚 国家格言	其他	句子
朝鲜 人类发展指数	数字	单个
朝鲜 最大城市	其他	单个
朝鲜 国家格言	其他	句子
莫桑比克 国花	百科实体	单个
莫桑比克 国家格言	其他	句子
巴拉圭 人类发展指数	数字	单个
巴拉圭 最大城市	其他	单个
巴拉圭 国花	百科实体	单个
厄立特里亚 国花	百科实体	单个
厄立特里亚 国家格言	其他	句子
伊拉克 最大城市	其他	单个
莱索托 国花	百科实体	单个
越南 最大城市	其他	单个
越南 国花	百科实体	单个
越南 国家格言	其他	句子
梵蒂冈 人类发展指数	数字	单个
梵蒂冈 最大城市	其他	单个
梵蒂冈 主要学府	其他	多个
梵蒂冈 主要城市	百科实体	多个
梵蒂冈 水域率	数字+单位	单个
梵蒂冈 国家格言	其他	句子
圣皮埃尔和密克隆 政治体制	其他	句子
圣皮埃尔和密克隆 国际域名缩写	其他	单个
圣皮埃尔和密克隆 人类发展指数	数字	单个
圣皮埃尔和密克隆 最大城市	其他	单个
圣皮埃尔和密克隆 简称	其他	单个
圣皮埃尔和密克隆 主要学府	其他	多个
圣皮埃尔和密克隆 GDP总计	数字+单位	单个
圣皮埃尔和密克隆 水域率	数字+单位	单个
圣皮埃尔和密克隆 国际电话区号	其他	单个
圣皮埃尔和密克隆 国花	百科实体	单个
圣皮埃尔和密克隆 国家格言	其他	句子
圣皮埃尔和密克隆 道路通行	其他	单个
加那利群岛 时区	其他	句子
加那利群岛 国家领袖	人名	多个
加那利群岛 首都	地名	单个
加那利群岛 政治体制	其他	句子
加那利群岛 国际域名缩写	其他	单个
加那利群岛 主要宗教	百科实体	多个
加那利群岛 人类发展指数	数字	单个
加那利群岛 最大城市	其他	单个
加那利群岛 简称	其他	单个
加那利群岛 主要学府	其他	多个
加那利群岛 主要城市	百科实体	多个
加那利群岛 国庆日	数字+单位	单个
加那利群岛 主要民族	百科实体	多个
加那利群岛 人口密度	数字+单位	单个
加那利群岛 国土面积	数字+单位	单个
加那利群岛 GDP总计	数字+单位	单个
加那利群岛 水域率	数字+单位	单个
加那利群岛 人均GDP	数字+单位	单个
加那利群岛 国际电话区号	其他	单个
加那利群岛 国花	百科实体	单个
加那利群岛 国家代码	其他	单个
加那利群岛 人口数量	数字+单位	单个
加那利群岛 官方语言	百科实体	单个
加那利群岛 所属洲	其他	单个
加那利群岛 货币	百科实体	单个
加那利群岛 国家格言	其他	句子
加那利群岛 道路通行	其他	单个
加那利群岛 英文名称	其他	多个
加那利群岛 国歌	百科实体	句子
尼加拉瓜 人类发展指数	数字	单个
尼加拉瓜 最大城市	其他	单个
尼加拉瓜 国花	百科实体	单个
尼加拉瓜 国家格言	其他	句子
法属波利尼西亚 国家领袖	人名	多个
法属波利尼西亚 首都	地名	单个
法属波利尼西亚 政治体制	其他	句子
法属波利尼西亚 主要宗教	百科实体	多个
法属波利尼西亚 人类发展指数	数字	单个
法属波利尼西亚 简称	其他	单个
法属波利尼西亚 主要学府	其他	多个
法属波利尼西亚 主要城市	百科实体	多个
法属波利尼西亚 国庆日	数字+单位	单个
法属波利尼西亚 主要民族	百科实体	多个
法属波利尼西亚 人口密度	数字+单位	单个
法属波利尼西亚 国土面积	数字+单位	单个
法属波利尼西亚 GDP总计	数字+单位	单个
法属波利尼西亚 水域率	数字+单位	单个
法属波利尼西亚 人均GDP	数字+单位	单个
法属波利尼西亚 国际电话区号	其他	单个
法属波利尼西亚 国花	百科实体	单个
法属波利尼西亚 国家代码	其他	单个
法属波利尼西亚 人口数量	数字+单位	单个
法属波利尼西亚 官方语言	百科实体	单个
法属波利尼西亚 所属洲	其他	单个
法属波利尼西亚 国家格言	其他	句子
法属波利尼西亚 道路通行	其他	单个
法属波利尼西亚 英文名称	其他	多个
法属波利尼西亚 国歌	百科实体	句子
巴拿马 人类发展指数	数字	单个
巴拿马 最大城市	其他	单个
巴拿马 国花	百科实体	单个
巴拿马 国家格言	其他	句子
西撒哈拉 人类发展指数	数字	单个
西撒哈拉 最大城市	其他	单个
西撒哈拉 主要学府	其他	多个
西撒哈拉 国花	百科实体	单个
西撒哈拉 国家格言	其他	句子
英属维尔京群岛 时区	其他	句子
英属维尔京群岛 政治体制	其他	句子
英属维尔京群岛 国际域名缩写	其他	单个
英属维尔京群岛 人类发展指数	数字	单个
英属维尔京群岛 最大城市	其他	单个
英属维尔京群岛 主要城市	百科实体	多个
英属维尔京群岛 国庆日	数字+单位	单个
英属维尔京群岛 GDP总计	数字+单位	单个
英属维尔京群岛 水域率	数字+单位	单个
英属维尔京群岛 人均GDP	数字+单位	单个
英属维尔京群岛 国际电话区号	其他	单个
英属维尔京群岛 国花	百科实体	单个
英属维尔京群岛 国家格言	其他	句子
英属维尔京群岛 道路通行	其他	单个
英属维尔京群岛 国歌	百科实体	句子
吉尔吉斯斯坦 人类发展指数	数字	单个
吉尔吉斯斯坦 国花	百科实体	单个
吉尔吉斯斯坦 国家格言	其他	句子
摩纳哥 最大城市	其他	单个
摩纳哥 国花	百科实体	单个
埃塞俄比亚 国花	百科实体	单个
埃塞俄比亚 国家格言	其他	句子
老挝 水域率	数字+单位	单个
帕劳 最大城市	其他	单个
帕劳 水域率	数字+单位	单个
帕劳 国花	百科实体	单个
帕劳 国家格言	其他	句子
亚速尔群岛 时区	其他	句子
亚速尔群岛 国家领袖	人名	多个
亚速尔群岛 首都	地名	单个
亚速尔群岛 政治体制	其他	句子
亚速尔群岛 国际域名缩写	其他	单个
亚速尔群岛 主要宗教	百科实体	多个
亚速尔群岛 人类发展指数	数字	单个
亚速尔群岛 最大城市	其他	单个
亚速尔群岛 简称	其他	单个
亚速尔群岛 主要学府	其他	多个
亚速尔群岛 主要城市	百科实体	多个
亚速尔群岛 国庆日	数字+单位	单个
亚速尔群岛 主要民族	百科实体	多个
亚速尔群岛 人口密度	数字+单位	单个
亚速尔群岛 国土面积	数字+单位	单个
亚速尔群岛 中文名称	其他	句子
亚速尔群岛 GDP总计	数字+单位	单个
亚速尔群岛 水域率	数字+单位	单个
亚速尔群岛 人均GDP	数字+单位	单个
亚速尔群岛 国际电话区号	其他	单个
亚速尔群岛 国花	百科实体	单个
亚速尔群岛 国家代码	其他	单个
亚速尔群岛 人口数量	数字+单位	单个
亚速尔群岛 官方语言	百科实体	单个
亚速尔群岛 所属洲	其他	单个
亚速尔群岛 货币	百科实体	单个
亚速尔群岛 国家格言	其他	句子
亚速尔群岛 道路通行	其他	单个
亚速尔群岛 英文名称	其他	多个
亚速尔群岛 国歌	百科实体	句子
圣卢西亚 最大城市	其他	单个
圣卢西亚 简称	其他	单个
圣卢西亚 主要学府	其他	多个
圣卢西亚 国花	百科实体	单个
圣卢西亚 国家格言	其他	句子
印度 最大城市	其他	单个
塞舌尔 人类发展指数	数字	单个
塞舌尔 最大城市	其他	单个
塞舌尔 主要学府	其他	多个
塞舌尔 主要城市	百科实体	多个
塞舌尔 国花	百科实体	单个
塞舌尔 国家格言	其他	句子
毛里塔尼亚 最大城市	其他	单个
毛里塔尼亚 国花	百科实体	单个
安提瓜和巴布达 简称	其他	单个
安提瓜和巴布达 水域率	数字+单位	单个
安提瓜和巴布达 国花	百科实体	单个
蒙特塞拉特 国家领袖	人名	多个
蒙特塞拉特 国际域名缩写	其他	单个
蒙特塞拉特 人类发展指数	数字	单个
蒙特塞拉特 最大城市	其他	单个
蒙特塞拉特 简称	其他	单个
蒙特塞拉特 主要学府	其他	多个
蒙特塞拉特 主要城市	百科实体	多个
蒙特塞拉特 国庆日	数字+单位	单个
蒙特塞拉特 主要民族	百科实体	多个
蒙特塞拉特 人口密度	数字+单位	单个
蒙特塞拉特 GDP总计	数字+单位	单个
蒙特塞拉特 水域率	数字+单位	单个
蒙特塞拉特 人均GDP	数字+单位	单个
蒙特塞拉特 国际电话区号	其他	单个
蒙特塞拉特 国花	百科实体	单个
蒙特塞拉特 国家格言	其他	句子
蒙特塞拉特 道路通行	其他	单个
蒙特塞拉特 国歌	百科实体	句子
瑙鲁 人类发展指数	数字	单个
瑙鲁 最大城市	其他	单个
瑙鲁 国花	百科实体	单个
白俄罗斯 国家格言	其他	句子
格陵兰 最大城市	其他	单个
格陵兰 主要学府	其他	多个
格陵兰 水域率	数字+单位	单个
格陵兰 国花	百科实体	单个
格陵兰 国家格言	其他	句子
圣赫勒拿岛 首都	地名	单个
圣赫勒拿岛 政治体制	其他	句子
圣赫勒拿岛 人类发展指数	数字	单个
圣赫勒拿岛 最大城市	其他	单个
圣赫勒拿岛 主要学府	其他	多个
圣赫勒拿岛 国庆日	数字+单位	单个
圣赫勒拿岛 水域率	数字+单位	单个
圣赫勒拿岛 国花	百科实体	单个
圣赫勒拿岛 国家格言	其他	句子
圣基茨和尼维斯 人类发展指数	数字	单个
圣基茨和尼维斯 最大城市	其他	单个
圣基茨和尼维斯 主要学府	其他	多个
圣基茨和尼维斯 水域率	数字+单位	单个
圣基茨和尼维斯 国花	百科实体	单个
圣基茨和尼维斯 国家格言	其他	句子
苏丹 最大城市	其他	单个
苏丹 水域率	数字+单位	单个
苏丹 国花	百科实体	单个
苏丹 国家格言	其他	句子
斯洛伐克 国家格言	其他	句子
阿尔及利亚 人类发展指数	数字	单个
阿尔及利亚 最大城市	其他	单个
阿尔及利亚 水域率	数字+单位	单个
阿尔及利亚 国花	百科实体	单个
阿尔及利亚 国家格言	其他	句子
也门 最大城市	其他	单个
也门 水域率	数字+单位	单个
也门 国家格言	其他	句子
波斯尼亚和黑塞哥维那 人类发展指数	数字	单个
波斯尼亚和黑塞哥维那 最大城市	其他	单个
波斯尼亚和黑塞哥维那 国际电话区号	其他	单个
波斯尼亚和黑塞哥维那 国花	百科实体	单个
波斯尼亚和黑塞哥维那 国家格言	其他	句子
尼日尔 人类发展指数	数字	单个
尼日尔 最大城市	其他	单个
尼日尔 主要城市	百科实体	多个
尼日尔 水域率	数字+单位	单个
尼日尔 国花	百科实体	单个
尼日尔 国家格言	其他	句子
格林纳达 人类发展指数	数字	单个
格林纳达 简称	其他	单个
格林纳达 主要学府	其他	多个
格林纳达 国花	百科实体	单个
格林纳达 国家格言	其他	句子
拉脱维亚 国花	百科实体	单个
喀麦隆 最大城市	其他	单个
喀麦隆 国花	百科实体	单个
马其顿 人类发展指数	数字	单个
马其顿 最大城市	其他	单个
马其顿 国花	百科实体	单个
马其顿 国家格言	其他	句子
法罗群岛 国家领袖	人名	多个
法罗群岛 首都	地名	单个
法罗群岛 政治体制	其他	句子
法罗群岛 国际域名缩写	其他	单个
法罗群岛 主要宗教	百科实体	多个
法罗群岛 简称	其他	单个
法罗群岛 主要学府	其他	多个
法罗群岛 主要城市	百科实体	多个
法罗群岛 国庆日	数字+单位	单个
法罗群岛 主要民族	百科实体	多个
法罗群岛 国土面积	数字+单位	单个
法罗群岛 GDP总计	数字+单位	单个
法罗群岛 国际电话区号	其他	单个
法罗群岛 国花	百科实体	单个
法罗群岛 国家代码	其他	单个
法罗群岛 人口数量	数字+单位	单个
法罗群岛 官方语言	百科实体	单个
法罗群岛 所属洲	其他	单个
法罗群岛 国家格言	其他	句子
法罗群岛 道路通行	其他	单个
法罗群岛 英文名称	其他	多个
法罗群岛 国歌	百科实体	句子
土库曼斯坦 最大城市	其他	单个
土库曼斯坦 国花	百科实体	单个
土库曼斯坦 国家格言	其他	句子
格鲁吉亚 简称	其他	单个
格鲁吉亚 水域率	数字+单位	单个
格鲁吉亚 国花	百科实体	单个
关岛 国家领袖	人名	多个
关岛 首都	地名	单个
关岛 政治体制	其他	句子
关岛 国际域名缩写	其他	单个
关岛 主要宗教	百科实体	多个
关岛 人类发展指数	数字	单个
关岛 最大城市	其他	单个
关岛 简称	其他	单个
关岛 主要城市	百科实体	多个
关岛 国庆日	数字+单位	单个
关岛 主要民族	百科实体	多个
关岛 人口密度	数字+单位	单个
关岛 国土面积	数字+单位	单个
关岛 水域率	数字+单位	单个
关岛 人均GDP	数字+单位	单个
关岛 国际电话区号	其他	单个
关岛 国花	百科实体	单个
关岛 国家代码	其他	单个
关岛 人口数量	数字+单位	单个
关岛 官方语言	百科实体	单个
关岛 所属洲	其他	单个
关岛 国家格言	其他	句子
关岛 道路通行	其他	单个
关岛 英文名称	其他	多个
关岛 国歌	百科实体	句子
坦桑尼亚 人类发展指数	数字	单个
坦桑尼亚 最大城市	其他	单个
坦桑尼亚 国家格言	其他	句子
毛里求斯 国花	百科实体	单个
瓦利斯和富图纳 时区	其他	句子
瓦利斯和富图纳 国家领袖	人名	多个
瓦利斯和富图纳 首都	地名	单个
瓦利斯和富图纳 政治体制	其他	句子
瓦利斯和富图纳 国际域名缩写	其他	单个
瓦利斯和富图纳 主要宗教	百科实体	多个
瓦利斯和富图纳 人类发展指数	数字	单个
瓦利斯和富图纳 最大城市	其他	单个
瓦利斯和富图纳 简称	其他	单个
瓦利斯和富图纳 主要学府	其他	多个
瓦利斯和富图纳 主要城市	百科实体	多个
瓦利斯和富图纳 国庆日	数字+单位	单个
瓦利斯和富图纳 主要民族	百科实体	多个
瓦利斯和富图纳 人口密度	数字+单位	单个
瓦利斯和富图纳 国土面积	数字+单位	单个
瓦利斯和富图纳 GDP总计	数字+单位	单个
瓦利斯和富图纳 水域率	数字+单位	单个
瓦利斯和富图纳 人均GDP	数字+单位	单个
瓦利斯和富图纳 国际电话区号	其他	单个
瓦利斯和富图纳 国花	百科实体	单个
瓦利斯和富图纳 人口数量	数字+单位	单个
瓦利斯和富图纳 官方语言	百科实体	单个
瓦利斯和富图纳 所属洲	其他	单个
瓦利斯和富图纳 货币	百科实体	单个
瓦利斯和富图纳 国家格言	其他	句子
瓦利斯和富图纳 道路通行	其他	单个
瓦利斯和富图纳 英文名称	其他	多个
瓦利斯和富图纳 国歌	百科实体	句子
塞尔维亚 最大城市	其他	单个
塞尔维亚 主要学府	其他	多个
塞尔维亚 水域率	数字+单位	单个
塞尔维亚 国花	百科实体	单个
塞尔维亚 国家格言	其他	句子
列支敦士登 最大城市	其他	单个
波多黎各 时区	其他	句子
波多黎各 国家领袖	人名	多个
波多黎各 首都	地名	单个
波多黎各 政治体制	其他	句子
波多黎各 国际域名缩写	其他	单个
波多黎各 主要宗教	百科实体	多个
波多黎各 人类发展指数	数字	单个
波多黎各 最大城市	其他	单个
波多黎各 简称	其他	单个
波多黎各 国庆日	数字+单位	单个
波多黎各 主要民族	百科实体	多个
波多黎各 人口密度	数字+单位	单个
波多黎各 国土面积	数字+单位	单个
波多黎各 人均GDP	数字+单位	单个
波多黎各 国际电话区号	其他	单个
波多黎各 国花	百科实体	单个
波多黎各 国家代码	其他	单个
波多黎各 人口数量	数字+单位	单个
波多黎各 官方语言	百科实体	单个
波多黎各 所属洲	其他	单个
波多黎各 国家格言	其他	句子
波多黎各 道路通行	其他	单个
波多黎各 英文名称	其他	多个
波多黎各 国歌	百科实体	句子
洪都拉斯 人类发展指数	数字	单个
洪都拉斯 水域率	数字+单位	单个
美属萨摩亚 国家领袖	人名	多个
美属萨摩亚 首都	地名	单个
美属萨摩亚 政治体制	其他	句子
美属萨摩亚 国际域名缩写	其他	单个
美属萨摩亚 主要宗教	百科实体	多个
美属萨摩亚 人类发展指数	数字	单个
美属萨摩亚 最大城市	其他	单个
美属萨摩亚 简称	其他	单个
美属萨摩亚 主要学府	其他	多个
美属萨摩亚 主要城市	百科实体	多个
美属萨摩亚 国庆日	数字+单位	单个
美属萨摩亚 主要民族	百科实体	多个
美属萨摩亚 人口密度	数字+单位	单个
美属萨摩亚 国土面积	数字+单位	单个
美属萨摩亚 GDP总计	数字+单位	单个
美属萨摩亚 水域率	数字+单位	单个
美属萨摩亚 人均GDP	数字+单位	单个
美属萨摩亚 国际电话区号	其他	单个
美属萨摩亚 国花	百科实体	单个
美属萨摩亚 国家代码	其他	单个
美属萨摩亚 人口数量	数字+单位	单个
美属萨摩亚 官方语言	百科实体	单个
美属萨摩亚 所属洲	其他	单个
美属萨摩亚 货币	百科实体	单个
美属萨摩亚 国家格言	其他	句子
美属萨摩亚 英文名称	其他	多个
美属萨摩亚 国歌	百科实体	句子
布基纳法索 最大城市	其他	单个
布基纳法索 简称	其他	单个
布基纳法索 国花	百科实体	单个
布基纳法索 国家格言	其他	句子
萨尔瓦多 最大城市	其他	单个
美属维尔京群岛 政治体制	其他	句子
美属维尔京群岛 人类发展指数	数字	单个
美属维尔京群岛 最大城市	其他	单个
美属维尔京群岛 简称	其他	单个
美属维尔京群岛 主要学府	其他	多个
美属维尔京群岛 国庆日	数字+单位	单个
美属维尔京群岛 国花	百科实体	单个
美属维尔京群岛 国家格言	其他	句子
特克斯和凯科斯群岛 政治体制	其他	句子
特克斯和凯科斯群岛 主要宗教	百科实体	多个
特克斯和凯科斯群岛 人类发展指数	数字	单个
特克斯和凯科斯群岛 最大城市	其他	单个
特克斯和凯科斯群岛 简称	其他	单个
特克斯和凯科斯群岛 主要学府	其他	多个
特克斯和凯科斯群岛 国庆日	数字+单位	单个
特克斯和凯科斯群岛 水域率	数字+单位	单个
特克斯和凯科斯群岛 国花	百科实体	单个
特克斯和凯科斯群岛 所属洲	其他	单个
特克斯和凯科斯群岛 国家格言	其他	句子
沙特阿拉伯 最大城市	其他	单个
沙特阿拉伯 水域率	数字+单位	单个
沙特阿拉伯 国花	百科实体	单个
沙特阿拉伯 国家格言	其他	句子
秘鲁 人类发展指数	数字	单个
秘鲁 最大城市	其他	单个
秘鲁 国家格言	其他	句子
南苏丹 人类发展指数	数字	单个
南苏丹 最大城市	其他	单个
南苏丹 水域率	数字+单位	单个
南苏丹 国花	百科实体	单个
厄瓜多尔 主要学府	其他	多个
玻利维亚 人类发展指数	数字	单个
玻利维亚 最大城市	其他	单个
玻利维亚 国花	百科实体	单个
玻利维亚 国家格言	其他	句子
阿拉伯联合酋长国 最大城市	其他	单个
阿拉伯联合酋长国 国家格言	其他	句子
荷属圣马丁 时区	其他	句子
荷属圣马丁 国家领袖	人名	多个
荷属圣马丁 首都	地名	单个
荷属圣马丁 政治体制	其他	句子
荷属圣马丁 国际域名缩写	其他	单个
荷属圣马丁 主要宗教	百科实体	多个
荷属圣马丁 人类发展指数	数字	单个
荷属圣马丁 最大城市	其他	单个
荷属圣马丁 主要学府	其他	多个
荷属圣马丁 主要城市	百科实体	多个
荷属圣马丁 国庆日	数字+单位	单个
荷属圣马丁 主要民族	百科实体	多个
荷属圣马丁 国土面积	数字+单位	单个
荷属圣马丁 GDP总计	数字+单位	单个
荷属圣马丁 水域率	数字+单位	单个
荷属圣马丁 人均GDP	数字+单位	单个
荷属圣马丁 国际电话区号	其他	单个
荷属圣马丁 国花	百科实体	单个
荷属圣马丁 国家代码	其他	单个
荷属圣马丁 官方语言	百科实体	单个
荷属圣马丁 所属洲	其他	单个
荷属圣马丁 货币	百科实体	单个
荷属圣马丁 国家格言	其他	句子
荷属圣马丁 道路通行	其他	单个
荷属圣马丁 国歌	百科实体	句子
塞浦路斯 人类发展指数	数字	单个
塞浦路斯 最大城市	其他	单个
塞浦路斯 水域率	数字+单位	单个
塞浦路斯 国花	百科实体	单个
塞浦路斯 国家格言	其他	句子
皮特凯恩群岛 国家领袖	人名	多个
皮特凯恩群岛 首都	地名	单个
皮特凯恩群岛 政治体制	其他	句子
皮特凯恩群岛 国际域名缩写	其他	单个
皮特凯恩群岛 主要宗教	百科实体	多个
皮特凯恩群岛 人类发展指数	数字	单个
皮特凯恩群岛 最大城市	其他	单个
皮特凯恩群岛 简称	其他	单个
皮特凯恩群岛 主要学府	其他	多个
皮特凯恩群岛 主要城市	百科实体	多个
皮特凯恩群岛 国庆日	数字+单位	单个
皮特凯恩群岛 主要民族	百科实体	多个
皮特凯恩群岛 人口密度	数字+单位	单个
皮特凯恩群岛 国土面积	数字+单位	单个
皮特凯恩群岛 GDP总计	数字+单位	单个
皮特凯恩群岛 水域率	数字+单位	单个
皮特凯恩群岛 人均GDP	数字+单位	单个
皮特凯恩群岛 国际电话区号	其他	单个
皮特凯恩群岛 国花	百科实体	单个
皮特凯恩群岛 人口数量	数字+单位	单个
皮特凯恩群岛 官方语言	百科实体	单个
皮特凯恩群岛 所属洲	其他	单个
皮特凯恩群岛 货币	百科实体	单个
皮特凯恩群岛 国家格言	其他	句子
皮特凯恩群岛 道路通行	其他	单个
皮特凯恩群岛 英文名称	其他	多个
皮特凯恩群岛 国歌	百科实体	句子
圣马力诺 人类发展指数	数字	单个
圣马力诺 最大城市	其他	单个
圣马力诺 主要学府	其他	多个
圣马力诺 水域率	数字+单位	单个
圣马力诺 国家格言	其他	句子
博茨瓦纳 国花	百科实体	单个
马提尼克 时区	其他	句子
马提尼克 国家领袖	人名	多个
马提尼克 首都	地名	单个
马提尼克 政治体制	其他	句子
马提尼克 国际域名缩写	其他	单个
马提尼克 人类发展指数	数字	单个
马提尼克 最大城市	其他	单个
马提尼克 简称	其他	单个
马提尼克 主要学府	其他	多个
马提尼克 主要城市	百科实体	多个
马提尼克 国庆日	数字+单位	单个
马提尼克 人口密度	数字+单位	单个
马提尼克 国土面积	数字+单位	单个
马提尼克 GDP总计	数字+单位	单个
马提尼克 水域率	数字+单位	单个
马提尼克 人均GDP	数字+单位	单个
马提尼克 国际电话区号	其他	单个
马提尼克 国花	百科实体	单个
马提尼克 国家代码	其他	单个
马提尼克 人口数量	数字+单位	单个
马提尼克 所属洲	其他	单个
马提尼克 国家格言	其他	句子
马提尼克 道路通行	其他	单个
马提尼克 英文名称	其他	多个
马提尼克 国歌	百科实体	句子
几内亚比绍 最大城市	其他	单个
几内亚比绍 国花	百科实体	单个
哈萨克斯坦 最大城市	其他	单个
哈萨克斯坦 主要学府	其他	多个
哈萨克斯坦 国花	百科实体	单个
哈萨克斯坦 国家格言	其他	句子
塞拉利昂 最大城市	其他	单个
塞拉利昂 国花	百科实体	单个
塞拉利昂 国家格言	其他	句子
阿塞拜疆 最大城市	其他	单个
阿塞拜疆 国花	百科实体	单个
阿塞拜疆 国家格言	其他	句子
黑山 简称	其他	单个
黑山 国花	百科实体	单个
黑山 国家格言	其他	句子
乌克兰 人类发展指数	数字	单个
乌克兰 最大城市	其他	单个
乌克兰 简称	其他	单个
乌克兰 国花	百科实体	单个
乌克兰 国家格言	其他	句子
乌拉圭 最大城市	其他	单个
乌拉圭 国花	百科实体	单个
安圭拉 国家领袖	人名	多个
安圭拉 首都	地名	单个
安圭拉 政治体制	其他	句子
安圭拉 人类发展指数	数字	单个
安圭拉 最大城市	其他	单个
安圭拉 简称	其他	单个
安圭拉 主要学府	其他	多个
安圭拉 主要城市	百科实体	多个
安圭拉 国庆日	数字+单位	单个
安圭拉 人口密度	数字+单位	单个
安圭拉 国土面积	数字+单位	单个
安圭拉 GDP总计	数字+单位	单个
安圭拉 水域率	数字+单位	单个
安圭拉 人均GDP	数字+单位	单个
安圭拉 国际电话区号	其他	单个
安圭拉 国花	百科实体	单个
安圭拉 人口数量	数字+单位	单个
安圭拉 官方语言	百科实体	单个
安圭拉 所属洲	其他	单个
安圭拉 国家格言	其他	句子
安圭拉 道路通行	其他	单个
安圭拉 英文名称	其他	多个
安圭拉 国歌	百科实体	句子
苏里南 人类发展指数	数字	单个
苏里南 最大城市	其他	单个
苏里南 国花	百科实体	单个
苏里南 国家格言	其他	句子
塔吉克斯坦 人类发展指数	数字	单个
塔吉克斯坦 最大城市	其他	单个
塔吉克斯坦 国花	百科实体	单个
塔吉克斯坦 国家格言	其他	句子
乌干达 人类发展指数	数字	单个
乌干达 最大城市	其他	单个
乌干达 国花	百科实体	单个
乌干达 国家格言	其他	句子
加拿大 国家格言	其他	句子
日本 最大城市	其他	单个
日本 国花	百科实体	单个
日本 国家格言	其他	句子
爱沙尼亚 国家格言	其他	句子
图瓦卢 人类发展指数	数字	单个
图瓦卢 最大城市	其他	单个
图瓦卢 简称	其他	单个
图瓦卢 主要学府	其他	多个
图瓦卢 国花	百科实体	单个
图瓦卢 国家格言	其他	句子
马达加斯加 人类发展指数	数字	单个
马达加斯加 最大城市	其他	单个
马达加斯加 国花	百科实体	单个
马达加斯加 国家格言	其他	句子
冈比亚 最大城市	其他	单个
冈比亚 国花	百科实体	单个
新加坡 最大城市	其他	单个
新加坡 主要城市	百科实体	多个
新加坡 国花	百科实体	单个
新加坡 国家格言	其他	句子
塞内加尔 人类发展指数	数字	单个
塞内加尔 最大城市	其他	单个
塞内加尔 主要城市	百科实体	多个
塞内加尔 国花	百科实体	单个
塞内加尔 国家格言	其他	句子
科威特 主要学府	其他	多个
科威特 主要城市	百科实体	多个
科威特 水域率	数字+单位	单个
科威特 国花	百科实体	单个
科威特 国家格言	其他	句子
牙买加 简称	其他	单个
牙买加 水域率	数字+单位	单个
牙买加 国花	百科实体	单个
