贵阳市 现任领导	人名	多个
贵阳市 GDP	数字+单位	单个
贵阳市 高等院校	地名	多个
贵阳市 人均生产总值	数字+单位	单个
长春市 GDP	数字+单位	单个
长春市 高等院校	地名	多个
七台河市 市花	百科实体	单个
七台河市 地区生产总值	数字+单位	单个
七台河市 别名	其他	多个
七台河市 机场	百科实体	单个
七台河市 人均生产总值	数字+单位	单个
达州市 GDP	数字+单位	单个
达州市 高等院校	地名	多个
达州市 人均生产总值	数字+单位	单个
徐州市 行政代码	数字	单个
徐州市 GDP	数字+单位	单个
徐州市 高等院校	地名	多个
绵阳市 行政代码	数字	单个
绵阳市 市花	百科实体	单个
绵阳市 现任领导	人名	多个
绵阳市 GDP	数字+单位	单个
绵阳市 地区生产总值	数字+单位	单个
绵阳市 高等院校	地名	多个
绵阳市 市委书记	人名	单个
绵阳市 人均生产总值	数字+单位	单个
绵阳市 市长	人名	单个
厦门市 行政代码	数字	单个
厦门市 现任领导	人名	多个
厦门市 GDP	数字+单位	单个
厦门市 高等院校	地名	多个
厦门市 人均生产总值	数字+单位	单个
阿拉善盟 行政代码	数字	单个
阿拉善盟 市花	百科实体	单个
阿拉善盟 现任领导	人名	多个
阿拉善盟 GDP	数字+单位	单个
阿拉善盟 高等院校	地名	多个
阿拉善盟 市委书记	人名	单个
阿拉善盟 人均生产总值	数字+单位	单个
阿拉善盟 市长	人名	单个
常德市 行政代码	数字	单个
常德市 市花	百科实体	单个
常德市 GDP	数字+单位	单个
常德市 高等院校	地名	多个
咸宁市 地区生产总值	数字+单位	单个
咸宁市 高等院校	地名	多个
咸宁市 人均生产总值	数字+单位	单个
江门市 市花	百科实体	单个
江门市 现任领导	人名	多个
江门市 GDP	数字+单位	单个
江门市 机场	百科实体	单个
江门市 市委书记	人名	单个
江门市 市长	人名	单个
安阳市 行政代码	数字	单个
安阳市 市花	百科实体	单个
安阳市 现任领导	人名	多个
安阳市 GDP	数字+单位	单个
安阳市 地区生产总值	数字+单位	单个
安阳市 高等院校	地名	多个
安阳市 市委书记	人名	单个
安阳市 人均生产总值	数字+单位	单个
安阳市 市长	人名	单个
定西市 市花	百科实体	单个
定西市 现任领导	人名	多个
定西市 GDP	数字+单位	单个
定西市 地区生产总值	数字+单位	单个
定西市 机场	百科实体	单个
定西市 人均生产总值	数字+单位	单个
定西市 市长	人名	单个
乌鲁木齐市 市花	百科实体	单个
乌鲁木齐市 现任领导	人名	多个
乌鲁木齐市 GDP	数字+单位	单个
乌鲁木齐市 高等院校	地名	多个
安康市 行政代码	数字	单个
安康市 市花	百科实体	单个
安康市 GDP	数字+单位	单个
安康市 地区生产总值	数字+单位	单个
安康市 人均生产总值	数字+单位	单个
邢台市 GDP	数字+单位	单个
邢台市 高等院校	地名	多个
邢台市 市委书记	人名	单个
邢台市 人均生产总值	数字+单位	单个
邢台市 市长	人名	单个
吴忠市 市花	百科实体	单个
吴忠市 现任领导	人名	多个
吴忠市 GDP	数字+单位	单个
海北藏族自治州 行政代码	数字	单个
海北藏族自治州 市花	百科实体	单个
海北藏族自治州 现任领导	人名	多个
海北藏族自治州 GDP	数字+单位	单个
海北藏族自治州 地区生产总值	数字+单位	单个
海北藏族自治州 高等院校	地名	多个
海北藏族自治州 市委书记	人名	单个
海北藏族自治州 人均生产总值	数字+单位	单个
海北藏族自治州 市长	人名	单个
昌都市 市花	百科实体	单个
昌都市 GDP	数字+单位	单个
昌都市 地区生产总值	数字+单位	单个
昌都市 高等院校	地名	多个
昌都市 人均生产总值	数字+单位	单个
黑河市 地区生产总值	数字+单位	单个
黑河市 高等院校	地名	多个
黑河市 人均生产总值	数字+单位	单个
吉安市 现任领导	人名	多个
吉安市 GDP	数字+单位	单个
吉安市 地区生产总值	数字+单位	单个
吉安市 人均生产总值	数字+单位	单个
迪庆藏族自治州 市花	百科实体	单个
迪庆藏族自治州 现任领导	人名	多个
迪庆藏族自治州 GDP	数字+单位	单个
迪庆藏族自治州 地区生产总值	数字+单位	单个
迪庆藏族自治州 别名	其他	多个
迪庆藏族自治州 方言	百科实体	单个
迪庆藏族自治州 高等院校	地名	多个
迪庆藏族自治州 市委书记	人名	单个
迪庆藏族自治州 人均生产总值	数字+单位	单个
迪庆藏族自治州 市长	人名	单个
遵义市 现任领导	人名	多个
遵义市 GDP	数字+单位	单个
遵义市 人均生产总值	数字+单位	单个
鸡西市 市花	百科实体	单个
鸡西市 地区生产总值	数字+单位	单个
鸡西市 高等院校	地名	多个
鸡西市 人均生产总值	数字+单位	单个
果洛藏族自治州 行政代码	数字	单个
果洛藏族自治州 市花	百科实体	单个
果洛藏族自治州 现任领导	人名	多个
果洛藏族自治州 GDP	数字+单位	单个
果洛藏族自治州 地区生产总值	数字+单位	单个
果洛藏族自治州 市委书记	人名	单个
果洛藏族自治州 人均生产总值	数字+单位	单个
果洛藏族自治州 市长	人名	单个
金华市 现任领导	人名	多个
金华市 GDP	数字+单位	单个
金华市 市委书记	人名	单个
金华市 人均生产总值	数字+单位	单个
金华市 市长	人名	单个
大连市 行政代码	数字	单个
大连市 地区生产总值	数字+单位	单个
大连市 高等院校	地名	多个
大连市 人均生产总值	数字+单位	单个
陇南市 行政代码	数字	单个
陇南市 市花	百科实体	单个
陇南市 现任领导	人名	多个
陇南市 GDP	数字+单位	单个
陇南市 人均生产总值	数字+单位	单个
扬州市 现任领导	人名	多个
扬州市 地区生产总值	数字+单位	单个
扬州市 高等院校	地名	多个
扬州市 人均生产总值	数字+单位	单个
湘西土家族苗族自治州 行政代码	数字	单个
湘西土家族苗族自治州 市花	百科实体	单个
湘西土家族苗族自治州 现任领导	人名	多个
湘西土家族苗族自治州 GDP	数字+单位	单个
湘西土家族苗族自治州 高等院校	地名	多个
湘西土家族苗族自治州 市委书记	人名	单个
湘西土家族苗族自治州 人均生产总值	数字+单位	单个
湘西土家族苗族自治州 市长	人名	单个
河池市 市花	百科实体	单个
河池市 GDP	数字+单位	单个
河池市 高等院校	地名	多个
河池市 人均生产总值	数字+单位	单个
伊春市 市花	百科实体	单个
伊春市 现任领导	人名	多个
伊春市 地区生产总值	数字+单位	单个
伊春市 高等院校	地名	多个
伊春市 市委书记	人名	单个
伊春市 人均生产总值	数字+单位	单个
伊春市 市长	人名	单个
嘉峪关市 行政代码	数字	单个
嘉峪关市 市花	百科实体	单个
嘉峪关市 地区生产总值	数字+单位	单个
嘉峪关市 高等院校	地名	多个
嘉峪关市 人均生产总值	数字+单位	单个
庆阳市 行政代码	数字	单个
庆阳市 市花	百科实体	单个
庆阳市 现任领导	人名	多个
庆阳市 地区生产总值	数字+单位	单个
庆阳市 高等院校	地名	多个
庆阳市 人均生产总值	数字+单位	单个
克孜勒苏柯尔克孜自治州 著名景点	百科实体	多个
克孜勒苏柯尔克孜自治州 行政代码	数字	单个
克孜勒苏柯尔克孜自治州 市花	百科实体	单个
克孜勒苏柯尔克孜自治州 现任领导	人名	多个
克孜勒苏柯尔克孜自治州 GDP	数字+单位	单个
克孜勒苏柯尔克孜自治州 地区生产总值	数字+单位	单个
克孜勒苏柯尔克孜自治州 高等院校	地名	多个
克孜勒苏柯尔克孜自治州 市委书记	人名	单个
克孜勒苏柯尔克孜自治州 人均生产总值	数字+单位	单个
克孜勒苏柯尔克孜自治州 市长	人名	单个
衡阳市 行政代码	数字	单个
衡阳市 市花	百科实体	单个
衡阳市 现任领导	人名	多个
衡阳市 GDP	数字+单位	单个
铜陵市 行政代码	数字	单个
铜陵市 市花	百科实体	单个
铜陵市 现任领导	人名	多个
铜陵市 GDP	数字+单位	单个
铜陵市 地区生产总值	数字+单位	单个
铜陵市 机场	百科实体	单个
铜陵市 高等院校	地名	多个
铜陵市 人均生产总值	数字+单位	单个
南昌市 现任领导	人名	多个
南昌市 GDP	数字+单位	单个
南昌市 高等院校	地名	多个
牡丹江市 现任领导	人名	多个
牡丹江市 地区生产总值	数字+单位	单个
牡丹江市 高等院校	地名	多个
牡丹江市 人均生产总值	数字+单位	单个
鄂州市 现任领导	人名	多个
鄂州市 GDP	数字+单位	单个
曲靖市 市花	百科实体	单个
曲靖市 现任领导	人名	多个
曲靖市 地区生产总值	数字+单位	单个
曲靖市 市委书记	人名	单个
曲靖市 人均生产总值	数字+单位	单个
曲靖市 市长	人名	单个
遂宁市 现任领导	人名	多个
遂宁市 GDP	数字+单位	单个
遂宁市 高等院校	地名	多个
遂宁市 市委书记	人名	单个
遂宁市 人均生产总值	数字+单位	单个
遂宁市 市长	人名	单个
三明市 行政代码	数字	单个
三明市 现任领导	人名	多个
三明市 GDP	数字+单位	单个
三明市 别名	其他	多个
三明市 市委书记	人名	单个
三明市 市长	人名	单个
娄底市 GDP	数字+单位	单个
娄底市 高等院校	地名	多个
阿里地区 著名景点	百科实体	多个
阿里地区 火车站	百科实体	多个
阿里地区 市花	百科实体	单个
阿里地区 现任领导	人名	多个
阿里地区 GDP	数字+单位	单个
阿里地区 地区生产总值	数字+单位	单个
阿里地区 高等院校	地名	多个
阿里地区 市委书记	人名	单个
阿里地区 人均生产总值	数字+单位	单个
阿里地区 市长	人名	单个
黄石市 行政代码	数字	单个
黄石市 GDP	数字+单位	单个
黄石市 地区生产总值	数字+单位	单个
黄石市 别名	其他	多个
黄石市 人均生产总值	数字+单位	单个
包头市 行政代码	数字	单个
包头市 现任领导	人名	多个
包头市 GDP	数字+单位	单个
包头市 高等院校	地名	多个
普洱市 著名景点	百科实体	多个
普洱市 市花	百科实体	单个
普洱市 现任领导	人名	多个
普洱市 GDP	数字+单位	单个
普洱市 地区生产总值	数字+单位	单个
普洱市 高等院校	地名	多个
普洱市 市委书记	人名	单个
普洱市 人均生产总值	数字+单位	单个
普洱市 市长	人名	单个
开封市 行政代码	数字	单个
开封市 现任领导	人名	多个
开封市 地区生产总值	数字+单位	单个
开封市 高等院校	地名	多个
开封市 市委书记	人名	单个
开封市 人均生产总值	数字+单位	单个
荆州市 市花	百科实体	单个
荆州市 GDP	数字+单位	单个
荆州市 人均生产总值	数字+单位	单个
聊城市 行政代码	数字	单个
聊城市 市花	百科实体	单个
聊城市 现任领导	人名	多个
聊城市 GDP	数字+单位	单个
聊城市 地区生产总值	数字+单位	单个
聊城市 高等院校	地名	多个
聊城市 市委书记	人名	单个
聊城市 人均生产总值	数字+单位	单个
聊城市 市长	人名	单个
六盘水市 现任领导	人名	多个
六盘水市 地区生产总值	数字+单位	单个
六盘水市 高等院校	地名	多个
六盘水市 人均生产总值	数字+单位	单个
资阳市 市花	百科实体	单个
资阳市 现任领导	人名	多个
资阳市 GDP	数字+单位	单个
资阳市 高等院校	地名	多个
资阳市 人均生产总值	数字+单位	单个
长治市 GDP	数字+单位	单个
长治市 地区生产总值	数字+单位	单个
长治市 高等院校	地名	多个
长治市 人均生产总值	数字+单位	单个
临沧市 市花	百科实体	单个
临沧市 现任领导	人名	多个
临沧市 GDP	数字+单位	单个
临沧市 地区生产总值	数字+单位	单个
临沧市 别名	其他	多个
临沧市 市委书记	人名	单个
临沧市 人均生产总值	数字+单位	单个
吉林市 行政代码	数字	单个
吉林市 现任领导	人名	多个
吉林市 地区生产总值	数字+单位	单个
吉林市 高等院校	地名	多个
吉林市 人均生产总值	数字+单位	单个
玉溪市 市花	百科实体	单个
玉溪市 现任领导	人名	多个
玉溪市 GDP	数字+单位	单个
玉溪市 地区生产总值	数字+单位	单个
玉溪市 别名	其他	多个
玉溪市 机场	百科实体	单个
玉溪市 高等院校	地名	多个
玉溪市 市委书记	人名	单个
玉溪市 人均生产总值	数字+单位	单个
玉溪市 市长	人名	单个
郑州市 地区生产总值	数字+单位	单个
郑州市 高等院校	地名	多个
郑州市 人均生产总值	数字+单位	单个
淮南市 现任领导	人名	多个
淮南市 GDP	数字+单位	单个
淮南市 高等院校	地名	多个
淮南市 人均生产总值	数字+单位	单个
延安市 行政代码	数字	单个
延安市 市花	百科实体	单个
延安市 现任领导	人名	多个
延安市 GDP	数字+单位	单个
延安市 地区生产总值	数字+单位	单个
延安市 高等院校	地名	多个
延安市 市委书记	人名	单个
延安市 人均生产总值	数字+单位	单个
延安市 市长	人名	单个
平凉市 现任领导	人名	多个
平凉市 地区生产总值	数字+单位	单个
平凉市 别名	其他	多个
平凉市 高等院校	地名	多个
平凉市 人均生产总值	数字+单位	单个
平凉市 市长	人名	单个
衡水市 地区生产总值	数字+单位	单个
衡水市 高等院校	地名	多个
衡水市 人均生产总值	数字+单位	单个
平顶山市 行政代码	数字	单个
平顶山市 市花	百科实体	单个
平顶山市 现任领导	人名	多个
平顶山市 地区生产总值	数字+单位	单个
平顶山市 人均生产总值	数字+单位	单个
马鞍山市 行政代码	数字	单个
马鞍山市 现任领导	人名	多个
马鞍山市 GDP	数字+单位	单个
马鞍山市 高等院校	地名	多个
马鞍山市 人均生产总值	数字+单位	单个
温州市 行政代码	数字	单个
温州市 现任领导	人名	多个
温州市 地区生产总值	数字+单位	单个
温州市 高等院校	地名	多个
温州市 市委书记	人名	单个
温州市 人均生产总值	数字+单位	单个
温州市 市长	人名	单个
襄阳市 行政代码	数字	单个
襄阳市 现任领导	人名	多个
襄阳市 GDP	数字+单位	单个
襄阳市 市委书记	人名	单个
襄阳市 人均生产总值	数字+单位	单个
福州市 现任领导	人名	多个
福州市 GDP	数字+单位	单个
福州市 人均生产总值	数字+单位	单个
兰州市 地区生产总值	数字+单位	单个
兰州市 高等院校	地名	多个
兰州市 人均生产总值	数字+单位	单个
天水市 行政代码	数字	单个
天水市 现任领导	人名	多个
天水市 地区生产总值	数字+单位	单个
天水市 市委书记	人名	单个
天水市 人均生产总值	数字+单位	单个
天水市 市长	人名	单个
忻州市 行政代码	数字	单个
忻州市 市花	百科实体	单个
忻州市 现任领导	人名	多个
忻州市 GDP	数字+单位	单个
忻州市 地区生产总值	数字+单位	单个
忻州市 高等院校	地名	多个
忻州市 市委书记	人名	单个
忻州市 人均生产总值	数字+单位	单个
忻州市 市长	人名	单个
西宁市 行政代码	数字	单个
西宁市 现任领导	人名	多个
西宁市 地区生产总值	数字+单位	单个
西宁市 高等院校	地名	多个
西宁市 人均生产总值	数字+单位	单个
丹东市 行政代码	数字	单个
丹东市 现任领导	人名	多个
丹东市 GDP	数字+单位	单个
丹东市 高等院校	地名	多个
丹东市 人均生产总值	数字+单位	单个
丹东市 市长	人名	单个
威海市 现任领导	人名	多个
威海市 GDP	数字+单位	单个
威海市 高等院校	地名	多个
东莞市 市花	百科实体	单个
东莞市 现任领导	人名	多个
东莞市 GDP	数字+单位	单个
东莞市 机场	百科实体	单个
东莞市 高等院校	地名	多个
东莞市 市委书记	人名	单个
东莞市 市长	人名	单个
长沙市 行政代码	数字	单个
长沙市 GDP	数字+单位	单个
长沙市 高等院校	地名	多个
朔州市 现任领导	人名	多个
朔州市 地区生产总值	数字+单位	单个
朔州市 高等院校	地名	多个
朔州市 人均生产总值	数字+单位	单个
丽水市 市花	百科实体	单个
丽水市 现任领导	人名	多个
丽水市 地区生产总值	数字+单位	单个
丽水市 高等院校	地名	多个
丽水市 市委书记	人名	单个
丽水市 人均生产总值	数字+单位	单个
丽水市 市长	人名	单个
潮州市 现任领导	人名	多个
潮州市 地区生产总值	数字+单位	单个
潮州市 高等院校	地名	多个
潮州市 市委书记	人名	单个
潮州市 人均生产总值	数字+单位	单个
潮州市 市长	人名	单个
宜春市 行政代码	数字	单个
宜春市 现任领导	人名	多个
宜春市 GDP	数字+单位	单个
宜春市 人均生产总值	数字+单位	单个
焦作市 市花	百科实体	单个
焦作市 现任领导	人名	多个
焦作市 地区生产总值	数字+单位	单个
焦作市 机场	百科实体	单个
焦作市 高等院校	地名	多个
焦作市 市委书记	人名	单个
焦作市 人均生产总值	数字+单位	单个
焦作市 市长	人名	单个
辽阳市 现任领导	人名	多个
辽阳市 GDP	数字+单位	单个
辽阳市 地区生产总值	数字+单位	单个
辽阳市 高等院校	地名	多个
辽阳市 市委书记	人名	单个
辽阳市 人均生产总值	数字+单位	单个
辽阳市 市长	人名	单个
阿坝藏族羌族自治州 行政代码	数字	单个
阿坝藏族羌族自治州 市花	百科实体	单个
阿坝藏族羌族自治州 现任领导	人名	多个
阿坝藏族羌族自治州 GDP	数字+单位	单个
阿坝藏族羌族自治州 高等院校	地名	多个
阿坝藏族羌族自治州 市委书记	人名	单个
阿坝藏族羌族自治州 市长	人名	单个
贺州市 行政代码	数字	单个
贺州市 市花	百科实体	单个
贺州市 现任领导	人名	多个
贺州市 地区生产总值	数字+单位	单个
贺州市 高等院校	地名	多个
贺州市 市委书记	人名	单个
贺州市 人均生产总值	数字+单位	单个
贺州市 市长	人名	单个
抚州市 GDP	数字+单位	单个
抚州市 人均生产总值	数字+单位	单个
恩施土家族苗族自治州 行政代码	数字	单个
恩施土家族苗族自治州 市花	百科实体	单个
恩施土家族苗族自治州 地区生产总值	数字+单位	单个
恩施土家族苗族自治州 高等院校	地名	多个
恩施土家族苗族自治州 市委书记	人名	单个
恩施土家族苗族自治州 人均生产总值	数字+单位	单个
恩施土家族苗族自治州 市长	人名	单个
烟台市 现任领导	人名	多个
烟台市 GDP	数字+单位	单个
烟台市 人均生产总值	数字+单位	单个
楚雄彝族自治州 著名景点	百科实体	多个
楚雄彝族自治州 地理位置	其他	句子
楚雄彝族自治州 火车站	百科实体	多个
楚雄彝族自治州 气候条件	其他	句子
楚雄彝族自治州 市花	百科实体	单个
楚雄彝族自治州 现任领导	人名	多个
楚雄彝族自治州 GDP	数字+单位	单个
楚雄彝族自治州 地区生产总值	数字+单位	单个
楚雄彝族自治州 机场	百科实体	单个
楚雄彝族自治州 方言	百科实体	单个
楚雄彝族自治州 高等院校	地名	多个
楚雄彝族自治州 市委书记	人名	单个
楚雄彝族自治州 人均生产总值	数字+单位	单个
楚雄彝族自治州 市长	人名	单个
柳州市 现任领导	人名	多个
柳州市 地区生产总值	数字+单位	单个
柳州市 高等院校	地名	多个
柳州市 人均生产总值	数字+单位	单个
宿州市 行政代码	数字	单个
宿州市 现任领导	人名	多个
宿州市 GDP	数字+单位	单个
宿州市 地区生产总值	数字+单位	单个
宿州市 高等院校	地名	多个
宿州市 市委书记	人名	单个
宿州市 人均生产总值	数字+单位	单个
宿州市 市长	人名	单个
德宏傣族景颇族自治州 火车站	百科实体	多个
德宏傣族景颇族自治州 市花	百科实体	单个
德宏傣族景颇族自治州 现任领导	人名	多个
德宏傣族景颇族自治州 GDP	数字+单位	单个
德宏傣族景颇族自治州 地区生产总值	数字+单位	单个
德宏傣族景颇族自治州 别名	其他	多个
德宏傣族景颇族自治州 高等院校	地名	多个
德宏傣族景颇族自治州 市委书记	人名	单个
德宏傣族景颇族自治州 人均生产总值	数字+单位	单个
德宏傣族景颇族自治州 市长	人名	单个
晋中市 现任领导	人名	多个
晋中市 GDP	数字+单位	单个
晋中市 高等院校	地名	多个
阿克苏地区 市花	百科实体	单个
阿克苏地区 现任领导	人名	多个
阿克苏地区 GDP	数字+单位	单个
阿克苏地区 市委书记	人名	单个
阿克苏地区 人均生产总值	数字+单位	单个
阿克苏地区 市长	人名	单个
珠海市 行政代码	数字	单个
珠海市 现任领导	人名	多个
珠海市 GDP	数字+单位	单个
珠海市 高等院校	地名	多个
珠海市 市委书记	人名	单个
珠海市 市长	人名	单个
石家庄市 地区生产总值	数字+单位	单个
石家庄市 高等院校	地名	多个
石家庄市 市委书记	人名	单个
石家庄市 人均生产总值	数字+单位	单个
南阳市 GDP	数字+单位	单个
南阳市 人均生产总值	数字+单位	单个
哈密市 行政代码	数字	单个
哈密市 市花	百科实体	单个
哈密市 现任领导	人名	多个
哈密市 GDP	数字+单位	单个
哈密市 地区生产总值	数字+单位	单个
哈密市 市委书记	人名	单个
哈密市 人均生产总值	数字+单位	单个
哈密市 市长	人名	单个
台州市 现任领导	人名	多个
台州市 地区生产总值	数字+单位	单个
台州市 高等院校	地名	多个
台州市 人均生产总值	数字+单位	单个
哈尔滨市 地区生产总值	数字+单位	单个
哈尔滨市 高等院校	地名	多个
哈尔滨市 人均生产总值	数字+单位	单个
承德市 GDP	数字+单位	单个
承德市 地区生产总值	数字+单位	单个
承德市 机场	百科实体	单个
承德市 高等院校	地名	多个
承德市 市委书记	人名	单个
承德市 人均生产总值	数字+单位	单个
承德市 市长	人名	单个
鹤壁市 行政代码	数字	单个
鹤壁市 市花	百科实体	单个
鹤壁市 现任领导	人名	多个
鹤壁市 地区生产总值	数字+单位	单个
鹤壁市 机场	百科实体	单个
鹤壁市 高等院校	地名	多个
鹤壁市 市委书记	人名	单个
鹤壁市 人均生产总值	数字+单位	单个
吐鲁番市 市花	百科实体	单个
吐鲁番市 现任领导	人名	多个
吐鲁番市 GDP	数字+单位	单个
吐鲁番市 地区生产总值	数字+单位	单个
吐鲁番市 市委书记	人名	单个
吐鲁番市 人均生产总值	数字+单位	单个
吐鲁番市 市长	人名	单个
桂林市 地区生产总值	数字+单位	单个
桂林市 高等院校	地名	多个
桂林市 市委书记	人名	单个
桂林市 人均生产总值	数字+单位	单个
鄂尔多斯市 行政代码	数字	单个
鄂尔多斯市 市花	百科实体	单个
鄂尔多斯市 现任领导	人名	多个
鄂尔多斯市 GDP	数字+单位	单个
鄂尔多斯市 高等院校	地名	多个
鄂尔多斯市 市委书记	人名	单个
鄂尔多斯市 市长	人名	单个
赣州市 现任领导	人名	多个
赣州市 GDP	数字+单位	单个
赣州市 人均生产总值	数字+单位	单个
海西蒙古族藏族自治州 行政代码	数字	单个
海西蒙古族藏族自治州 市花	百科实体	单个
海西蒙古族藏族自治州 现任领导	人名	多个
海西蒙古族藏族自治州 GDP	数字+单位	单个
海西蒙古族藏族自治州 地区生产总值	数字+单位	单个
海西蒙古族藏族自治州 高等院校	地名	多个
海西蒙古族藏族自治州 市委书记	人名	单个
海西蒙古族藏族自治州 人均生产总值	数字+单位	单个
海西蒙古族藏族自治州 市长	人名	单个
乌兰察布市 行政代码	数字	单个
乌兰察布市 市花	百科实体	单个
乌兰察布市 现任领导	人名	多个
乌兰察布市 GDP	数字+单位	单个
乌兰察布市 高等院校	地名	多个
乌兰察布市 市委书记	人名	单个
乌兰察布市 市长	人名	单个
营口市 行政代码	数字	单个
营口市 市花	百科实体	单个
营口市 现任领导	人名	多个
营口市 地区生产总值	数字+单位	单个
营口市 人均生产总值	数字+单位	单个
佳木斯市 行政代码	数字	单个
佳木斯市 市花	百科实体	单个
佳木斯市 现任领导	人名	多个
佳木斯市 GDP	数字+单位	单个
佳木斯市 地区生产总值	数字+单位	单个
佳木斯市 高等院校	地名	多个
佳木斯市 市委书记	人名	单个
佳木斯市 人均生产总值	数字+单位	单个
佳木斯市 市长	人名	单个
德州市 现任领导	人名	多个
德州市 GDP	数字+单位	单个
博尔塔拉蒙古自治州 行政代码	数字	单个
博尔塔拉蒙古自治州 市花	百科实体	单个
博尔塔拉蒙古自治州 现任领导	人名	多个
博尔塔拉蒙古自治州 GDP	数字+单位	单个
博尔塔拉蒙古自治州 地区生产总值	数字+单位	单个
博尔塔拉蒙古自治州 市委书记	人名	单个
博尔塔拉蒙古自治州 人均生产总值	数字+单位	单个
博尔塔拉蒙古自治州 市长	人名	单个
东营市 市花	百科实体	单个
东营市 现任领导	人名	多个
东营市 GDP	数字+单位	单个
东营市 高等院校	地名	多个
东营市 市委书记	人名	单个
东营市 市长	人名	单个
漯河市 市花	百科实体	单个
漯河市 现任领导	人名	多个
漯河市 地区生产总值	数字+单位	单个
漯河市 机场	百科实体	单个
漯河市 高等院校	地名	多个
漯河市 人均生产总值	数字+单位	单个
广元市 行政代码	数字	单个
广元市 现任领导	人名	多个
广元市 地区生产总值	数字+单位	单个
广元市 市委书记	人名	单个
广元市 人均生产总值	数字+单位	单个
广元市 市长	人名	单个
湛江市 现任领导	人名	多个
湛江市 地区生产总值	数字+单位	单个
湛江市 市委书记	人名	单个
湛江市 人均生产总值	数字+单位	单个
湛江市 市长	人名	单个
阳江市 行政代码	数字	单个
阳江市 现任领导	人名	多个
阳江市 地区生产总值	数字+单位	单个
阳江市 高等院校	地名	多个
阳江市 人均生产总值	数字+单位	单个
绥化市 市花	百科实体	单个
绥化市 地区生产总值	数字+单位	单个
绥化市 高等院校	地名	多个
绥化市 人均生产总值	数字+单位	单个
海东市 市花	百科实体	单个
海东市 现任领导	人名	多个
海东市 GDP	数字+单位	单个
海东市 地区生产总值	数字+单位	单个
海东市 别名	其他	多个
海东市 政府驻地	其他	单个
海东市 高等院校	地名	多个
海东市 市委书记	人名	单个
海东市 人均生产总值	数字+单位	单个
海东市 市长	人名	单个
梅州市 行政代码	数字	单个
梅州市 现任领导	人名	多个
梅州市 地区生产总值	数字+单位	单个
梅州市 市委书记	人名	单个
梅州市 人均生产总值	数字+单位	单个
延边朝鲜族自治州 市花	百科实体	单个
延边朝鲜族自治州 GDP	数字+单位	单个
延边朝鲜族自治州 高等院校	地名	多个
延边朝鲜族自治州 市委书记	人名	单个
延边朝鲜族自治州 人均生产总值	数字+单位	单个
延边朝鲜族自治州 市长	人名	单个
河源市 市花	百科实体	单个
河源市 现任领导	人名	多个
河源市 GDP	数字+单位	单个
河源市 人均生产总值	数字+单位	单个
南平市 行政代码	数字	单个
南平市 现任领导	人名	多个
南平市 GDP	数字+单位	单个
南平市 地区生产总值	数字+单位	单个
南平市 市委书记	人名	单个
南平市 人均生产总值	数字+单位	单个
南平市 市长	人名	单个
鹰潭市 现任领导	人名	多个
鹰潭市 地区生产总值	数字+单位	单个
鹰潭市 高等院校	地名	多个
鹰潭市 市委书记	人名	单个
鹰潭市 人均生产总值	数字+单位	单个
鹰潭市 市长	人名	单个
白银市 市花	百科实体	单个
白银市 GDP	数字+单位	单个
白银市 地区生产总值	数字+单位	单个
白银市 高等院校	地名	多个
白银市 人均生产总值	数字+单位	单个
邯郸市 行政代码	数字	单个
邯郸市 市花	百科实体	单个
邯郸市 GDP	数字+单位	单个
邯郸市 地区生产总值	数字+单位	单个
邯郸市 人均生产总值	数字+单位	单个
榆林市 行政代码	数字	单个
榆林市 GDP	数字+单位	单个
榆林市 市委书记	人名	单个
榆林市 市长	人名	单个
景德镇市 行政代码	数字	单个
景德镇市 现任领导	人名	多个
景德镇市 GDP	数字+单位	单个
景德镇市 地区生产总值	数字+单位	单个
景德镇市 高等院校	地名	多个
景德镇市 市委书记	人名	单个
景德镇市 人均生产总值	数字+单位	单个
景德镇市 市长	人名	单个
巴音郭楞蒙古自治州 市花	百科实体	单个
巴音郭楞蒙古自治州 GDP	数字+单位	单个
巴音郭楞蒙古自治州 市委书记	人名	单个
巴音郭楞蒙古自治州 人均生产总值	数字+单位	单个
巴音郭楞蒙古自治州 市长	人名	单个
山南市 市花	百科实体	单个
山南市 GDP	数字+单位	单个
山南市 地区生产总值	数字+单位	单个
山南市 高等院校	地名	多个
山南市 人均生产总值	数字+单位	单个
山南市 市长	人名	单个
秦皇岛市 地区生产总值	数字+单位	单个
秦皇岛市 高等院校	地名	多个
秦皇岛市 人均生产总值	数字+单位	单个
怀化市 GDP	数字+单位	单个
汉中市 行政代码	数字	单个
汉中市 现任领导	人名	多个
汉中市 GDP	数字+单位	单个
汉中市 高等院校	地名	多个
拉萨市 地区生产总值	数字+单位	单个
拉萨市 高等院校	地名	多个
拉萨市 人均生产总值	数字+单位	单个
呼和浩特市 现任领导	人名	多个
呼和浩特市 GDP	数字+单位	单个
呼和浩特市 高等院校	地名	多个
呼和浩特市 市委书记	人名	单个
呼和浩特市 人均生产总值	数字+单位	单个
亳州市 现任领导	人名	多个
亳州市 GDP	数字+单位	单个
亳州市 地区生产总值	数字+单位	单个
亳州市 高等院校	地名	多个
亳州市 市委书记	人名	单个
亳州市 人均生产总值	数字+单位	单个
亳州市 市长	人名	单个
安庆市 市花	百科实体	单个
安庆市 现任领导	人名	多个
安庆市 GDP	数字+单位	单个
安庆市 地区生产总值	数字+单位	单个
安庆市 高等院校	地名	多个
安庆市 市委书记	人名	单个
安庆市 人均生产总值	数字+单位	单个
安庆市 市长	人名	单个
重庆市 行政代码	数字	单个
重庆市 现任领导	人名	多个
重庆市 GDP	数字+单位	单个
重庆市 高等院校	地名	多个
肇庆市 市花	百科实体	单个
肇庆市 现任领导	人名	多个
肇庆市 GDP	数字+单位	单个
肇庆市 市委书记	人名	单个
肇庆市 市长	人名	单个
信阳市 行政代码	数字	单个
信阳市 市花	百科实体	单个
信阳市 GDP	数字+单位	单个
随州市 地区生产总值	数字+单位	单个
随州市 高等院校	地名	多个
随州市 人均生产总值	数字+单位	单个
晋城市 行政代码	数字	单个
晋城市 现任领导	人名	多个
晋城市 GDP	数字+单位	单个
晋城市 地区生产总值	数字+单位	单个
晋城市 机场	百科实体	单个
晋城市 高等院校	地名	多个
晋城市 人均生产总值	数字+单位	单个
白城市 行政代码	数字	单个
白城市 市花	百科实体	单个
白城市 现任领导	人名	多个
白城市 GDP	数字+单位	单个
白城市 地区生产总值	数字+单位	单个
白城市 高等院校	地名	多个
白城市 市委书记	人名	单个
白城市 人均生产总值	数字+单位	单个
白城市 市长	人名	单个
新乡市 现任领导	人名	多个
新乡市 高等院校	地名	多个
新乡市 人均生产总值	数字+单位	单个
内江市 现任领导	人名	多个
内江市 GDP	数字+单位	单个
内江市 高等院校	地名	多个
内江市 市委书记	人名	单个
内江市 市长	人名	单个
大庆市 市花	百科实体	单个
大庆市 现任领导	人名	多个
大庆市 GDP	数字+单位	单个
大庆市 人均生产总值	数字+单位	单个
六安市 地区生产总值	数字+单位	单个
六安市 人均生产总值	数字+单位	单个
济南市 现任领导	人名	多个
济南市 地区生产总值	数字+单位	单个
济南市 高等院校	地名	多个
济南市 人均生产总值	数字+单位	单个
新余市 市花	百科实体	单个
新余市 现任领导	人名	多个
新余市 GDP	数字+单位	单个
新余市 地区生产总值	数字+单位	单个
新余市 高等院校	地名	多个
新余市 市委书记	人名	单个
新余市 人均生产总值	数字+单位	单个
新余市 市长	人名	单个
塔城地区 著名景点	百科实体	多个
塔城地区 火车站	百科实体	多个
塔城地区 市花	百科实体	单个
塔城地区 现任领导	人名	多个
塔城地区 GDP	数字+单位	单个
塔城地区 地区生产总值	数字+单位	单个
塔城地区 高等院校	地名	多个
塔城地区 市委书记	人名	单个
塔城地区 人均生产总值	数字+单位	单个
塔城地区 市长	人名	单个
银川市 现任领导	人名	多个
银川市 GDP	数字+单位	单个
银川市 高等院校	地名	多个
百色市 市花	百科实体	单个
百色市 现任领导	人名	多个
百色市 GDP	数字+单位	单个
百色市 高等院校	地名	多个
百色市 市委书记	人名	单个
百色市 人均生产总值	数字+单位	单个
百色市 市长	人名	单个
巴中市 GDP	数字+单位	单个
巴中市 高等院校	地名	多个
酒泉市 行政代码	数字	单个
酒泉市 市花	百科实体	单个
酒泉市 现任领导	人名	多个
酒泉市 地区生产总值	数字+单位	单个
酒泉市 高等院校	地名	多个
酒泉市 人均生产总值	数字+单位	单个
酒泉市 市长	人名	单个
苏州市 GDP	数字+单位	单个
苏州市 高等院校	地名	多个
苏州市 市委书记	人名	单个
铜仁市 现任领导	人名	多个
铜仁市 地区生产总值	数字+单位	单个
铜仁市 别名	其他	多个
铜仁市 市委书记	人名	单个
铜仁市 人均生产总值	数字+单位	单个
铜仁市 市长	人名	单个
宿迁市 GDP	数字+单位	单个
宿迁市 高等院校	地名	多个
宿迁市 人均生产总值	数字+单位	单个
淄博市 行政代码	数字	单个
淄博市 现任领导	人名	多个
淄博市 GDP	数字+单位	单个
淄博市 高等院校	地名	多个
阜阳市 行政代码	数字	单个
阜阳市 现任领导	人名	多个
阜阳市 地区生产总值	数字+单位	单个
阜阳市 高等院校	地名	多个
阜阳市 人均生产总值	数字+单位	单个
盐城市 GDP	数字+单位	单个
盐城市 高等院校	地名	多个
盐城市 人均生产总值	数字+单位	单个
黔南布依族苗族自治州 行政代码	数字	单个
黔南布依族苗族自治州 市花	百科实体	单个
黔南布依族苗族自治州 现任领导	人名	多个
黔南布依族苗族自治州 GDP	数字+单位	单个
黔南布依族苗族自治州 地区生产总值	数字+单位	单个
黔南布依族苗族自治州 市委书记	人名	单个
黔南布依族苗族自治州 人均生产总值	数字+单位	单个
黔南布依族苗族自治州 市长	人名	单个
宁德市 行政代码	数字	单个
宁德市 市花	百科实体	单个
宁德市 现任领导	人名	多个
宁德市 GDP	数字+单位	单个
宁德市 地区生产总值	数字+单位	单个
宁德市 人均生产总值	数字+单位	单个
昌吉回族自治州 市花	百科实体	单个
昌吉回族自治州 现任领导	人名	多个
昌吉回族自治州 GDP	数字+单位	单个
昌吉回族自治州 地区生产总值	数字+单位	单个
昌吉回族自治州 别名	其他	多个
昌吉回族自治州 高等院校	地名	多个
昌吉回族自治州 市委书记	人名	单个
昌吉回族自治州 人均生产总值	数字+单位	单个
昌吉回族自治州 市长	人名	单个
防城港市 市花	百科实体	单个
防城港市 现任领导	人名	多个
防城港市 GDP	数字+单位	单个
防城港市 地区生产总值	数字+单位	单个
防城港市 别名	其他	多个
防城港市 机场	百科实体	单个
防城港市 高等院校	地名	多个
防城港市 市委书记	人名	单个
防城港市 人均生产总值	数字+单位	单个
防城港市 市长	人名	单个
湖州市 现任领导	人名	多个
湖州市 GDP	数字+单位	单个
湖州市 机场	百科实体	单个
湖州市 高等院校	地名	多个
湖州市 市委书记	人名	单个
湖州市 市长	人名	单个
儋州市 行政代码	数字	单个
儋州市 市花	百科实体	单个
儋州市 地区生产总值	数字+单位	单个
儋州市 高等院校	地名	多个
儋州市 人均生产总值	数字+单位	单个
日喀则市 市花	百科实体	单个
日喀则市 现任领导	人名	多个
日喀则市 GDP	数字+单位	单个
日喀则市 地区生产总值	数字+单位	单个
日喀则市 高等院校	地名	多个
日喀则市 市委书记	人名	单个
日喀则市 人均生产总值	数字+单位	单个
日喀则市 市长	人名	单个
甘南藏族自治州 行政代码	数字	单个
甘南藏族自治州 市花	百科实体	单个
甘南藏族自治州 现任领导	人名	多个
甘南藏族自治州 地区生产总值	数字+单位	单个
甘南藏族自治州 别名	其他	多个
甘南藏族自治州 高等院校	地名	多个
甘南藏族自治州 市委书记	人名	单个
甘南藏族自治州 人均生产总值	数字+单位	单个
甘南藏族自治州 市长	人名	单个
沈阳市 现任领导	人名	多个
沈阳市 地区生产总值	数字+单位	单个
沈阳市 高等院校	地名	多个
沈阳市 人均生产总值	数字+单位	单个
和田地区 行政代码	数字	单个
和田地区 市花	百科实体	单个
和田地区 现任领导	人名	多个
和田地区 GDP	数字+单位	单个
和田地区 高等院校	地名	多个
和田地区 市委书记	人名	单个
和田地区 人均生产总值	数字+单位	单个
和田地区 市长	人名	单个
荆门市 现任领导	人名	多个
荆门市 GDP	数字+单位	单个
荆门市 人均生产总值	数字+单位	单个
武汉市 行政代码	数字	单个
武汉市 GDP	数字+单位	单个
武汉市 高等院校	地名	多个
阿勒泰地区 行政代码	数字	单个
阿勒泰地区 市花	百科实体	单个
阿勒泰地区 现任领导	人名	多个
阿勒泰地区 GDP	数字+单位	单个
阿勒泰地区 地区生产总值	数字+单位	单个
阿勒泰地区 别名	其他	多个
阿勒泰地区 方言	百科实体	单个
阿勒泰地区 高等院校	地名	多个
阿勒泰地区 市委书记	人名	单个
阿勒泰地区 人均生产总值	数字+单位	单个
阿勒泰地区 市长	人名	单个
湘潭市 市花	百科实体	单个
湘潭市 现任领导	人名	多个
湘潭市 GDP	数字+单位	单个
韶关市 市花	百科实体	单个
韶关市 现任领导	人名	多个
韶关市 地区生产总值	数字+单位	单个
韶关市 市委书记	人名	单个
韶关市 人均生产总值	数字+单位	单个
韶关市 市长	人名	单个
莆田市 行政代码	数字	单个
莆田市 现任领导	人名	多个
莆田市 GDP	数字+单位	单个
莆田市 机场	百科实体	单个
莆田市 高等院校	地名	多个
莆田市 人均生产总值	数字+单位	单个
双鸭山市 市花	百科实体	单个
双鸭山市 现任领导	人名	多个
双鸭山市 地区生产总值	数字+单位	单个
双鸭山市 别名	其他	多个
双鸭山市 机场	百科实体	单个
双鸭山市 高等院校	地名	多个
双鸭山市 市委书记	人名	单个
双鸭山市 人均生产总值	数字+单位	单个
双鸭山市 市长	人名	单个
白山市 地区生产总值	数字+单位	单个
白山市 高等院校	地名	多个
白山市 人均生产总值	数字+单位	单个
洛阳市 行政代码	数字	单个
洛阳市 现任领导	人名	多个
洛阳市 地区生产总值	数字+单位	单个
洛阳市 高等院校	地名	多个
洛阳市 市委书记	人名	单个
洛阳市 人均生产总值	数字+单位	单个
洛阳市 市长	人名	单个
黄山市 GDP	数字+单位	单个
黄山市 地区生产总值	数字+单位	单个
黄山市 高等院校	地名	多个
黄山市 人均生产总值	数字+单位	单个
玉林市 现任领导	人名	多个
玉林市 地区生产总值	数字+单位	单个
玉林市 高等院校	地名	多个
玉林市 市委书记	人名	单个
玉林市 人均生产总值	数字+单位	单个
濮阳市 现任领导	人名	多个
濮阳市 GDP	数字+单位	单个
濮阳市 地区生产总值	数字+单位	单个
濮阳市 机场	百科实体	单个
濮阳市 高等院校	地名	多个
濮阳市 市委书记	人名	单个
濮阳市 人均生产总值	数字+单位	单个
廊坊市 行政代码	数字	单个
廊坊市 市花	百科实体	单个
廊坊市 现任领导	人名	多个
廊坊市 GDP	数字+单位	单个
廊坊市 高等院校	地名	多个
廊坊市 市委书记	人名	单个
廊坊市 人均生产总值	数字+单位	单个
廊坊市 市长	人名	单个
泰安市 行政代码	数字	单个
泰安市 现任领导	人名	多个
泰安市 GDP	数字+单位	单个
泰安市 地区生产总值	数字+单位	单个
泰安市 别名	其他	多个
泰安市 高等院校	地名	多个
泰安市 市委书记	人名	单个
泰安市 人均生产总值	数字+单位	单个
泰安市 市长	人名	单个
阜新市 行政代码	数字	单个
阜新市 市花	百科实体	单个
阜新市 现任领导	人名	多个
阜新市 GDP	数字+单位	单个
阜新市 地区生产总值	数字+单位	单个
阜新市 别名	其他	多个
阜新市 机场	百科实体	单个
阜新市 方言	百科实体	单个
阜新市 市委书记	人名	单个
阜新市 人均生产总值	数字+单位	单个
株洲市 现任领导	人名	多个
株洲市 GDP	数字+单位	单个
株洲市 市委书记	人名	单个
株洲市 人均生产总值	数字+单位	单个
株洲市 市长	人名	单个
南京市 现任领导	人名	多个
南京市 GDP	数字+单位	单个
南京市 高等院校	地名	多个
南京市 行政区类别	其他	单个
乐山市 GDP	数字+单位	单个
乐山市 高等院校	地名	多个
钦州市 市花	百科实体	单个
钦州市 现任领导	人名	多个
钦州市 GDP	数字+单位	单个
钦州市 机场	百科实体	单个
钦州市 市委书记	人名	单个
钦州市 人均生产总值	数字+单位	单个
钦州市 市长	人名	单个
张家口市 现任领导	人名	多个
张家口市 地区生产总值	数字+单位	单个
张家口市 高等院校	地名	多个
张家口市 市委书记	人名	单个
张家口市 人均生产总值	数字+单位	单个
张家口市 市长	人名	单个
宝鸡市 现任领导	人名	多个
宝鸡市 地区生产总值	数字+单位	单个
宝鸡市 人均生产总值	数字+单位	单个
临夏回族自治州 市花	百科实体	单个
临夏回族自治州 地区生产总值	数字+单位	单个
临夏回族自治州 高等院校	地名	多个
临夏回族自治州 市委书记	人名	单个
临夏回族自治州 人均生产总值	数字+单位	单个
临夏回族自治州 市长	人名	单个
广安市 GDP	数字+单位	单个
镇江市 行政代码	数字	单个
镇江市 地区生产总值	数字+单位	单个
镇江市 高等院校	地名	多个
镇江市 人均生产总值	数字+单位	单个
许昌市 行政代码	数字	单个
许昌市 现任领导	人名	多个
许昌市 GDP	数字+单位	单个
许昌市 地区生产总值	数字+单位	单个
许昌市 市委书记	人名	单个
许昌市 人均生产总值	数字+单位	单个
许昌市 市长	人名	单个
三门峡市 行政代码	数字	单个
三门峡市 市花	百科实体	单个
三门峡市 现任领导	人名	多个
三门峡市 高等院校	地名	多个
三门峡市 人均生产总值	数字+单位	单个
金昌市 行政代码	数字	单个
金昌市 市花	百科实体	单个
金昌市 现任领导	人名	多个
金昌市 GDP	数字+单位	单个
金昌市 地区生产总值	数字+单位	单个
金昌市 高等院校	地名	多个
金昌市 市委书记	人名	单个
金昌市 人均生产总值	数字+单位	单个
金昌市 市长	人名	单个
成都市 行政代码	数字	单个
成都市 现任领导	人名	多个
成都市 GDP	数字+单位	单个
成都市 高等院校	地名	多个
成都市 市委书记	人名	单个
成都市 市长	人名	单个
天津市 GDP	数字+单位	单个
天津市 高等院校	地名	多个
汕尾市 市花	百科实体	单个
汕尾市 现任领导	人名	多个
汕尾市 GDP	数字+单位	单个
汕尾市 地区生产总值	数字+单位	单个
汕尾市 高等院校	地名	多个
汕尾市 市委书记	人名	单个
汕尾市 人均生产总值	数字+单位	单个
汕尾市 市长	人名	单个
张掖市 行政代码	数字	单个
张掖市 市花	百科实体	单个
张掖市 现任领导	人名	多个
张掖市 地区生产总值	数字+单位	单个
张掖市 高等院校	地名	多个
张掖市 市委书记	人名	单个
张掖市 人均生产总值	数字+单位	单个
张掖市 市长	人名	单个
伊犁哈萨克自治州 行政代码	数字	单个
伊犁哈萨克自治州 市花	百科实体	单个
伊犁哈萨克自治州 现任领导	人名	多个
伊犁哈萨克自治州 GDP	数字+单位	单个
伊犁哈萨克自治州 地区生产总值	数字+单位	单个
伊犁哈萨克自治州 高等院校	地名	多个
伊犁哈萨克自治州 市委书记	人名	单个
伊犁哈萨克自治州 人均生产总值	数字+单位	单个
伊犁哈萨克自治州 市长	人名	单个
吕梁市 市花	百科实体	单个
吕梁市 现任领导	人名	多个
吕梁市 地区生产总值	数字+单位	单个
吕梁市 高等院校	地名	多个
吕梁市 人均生产总值	数字+单位	单个
呼伦贝尔市 行政代码	数字	单个
呼伦贝尔市 地区生产总值	数字+单位	单个
呼伦贝尔市 高等院校	地名	多个
呼伦贝尔市 人均生产总值	数字+单位	单个
商洛市 行政代码	数字	单个
商洛市 市花	百科实体	单个
商洛市 现任领导	人名	多个
商洛市 GDP	数字+单位	单个
商洛市 地区生产总值	数字+单位	单个
商洛市 高等院校	地名	多个
商洛市 市委书记	人名	单个
商洛市 人均生产总值	数字+单位	单个
商洛市 市长	人名	单个
深圳市 行政代码	数字	单个
深圳市 市花	百科实体	单个
深圳市 现任领导	人名	多个
深圳市 地区生产总值	数字+单位	单个
深圳市 高等院校	地名	多个
深圳市 市委书记	人名	单个
深圳市 人均生产总值	数字+单位	单个
深圳市 市长	人名	单个
菏泽市 现任领导	人名	多个
菏泽市 GDP	数字+单位	单个
菏泽市 地区生产总值	数字+单位	单个
菏泽市 高等院校	地名	多个
菏泽市 市委书记	人名	单个
菏泽市 人均生产总值	数字+单位	单个
菏泽市 市长	人名	单个
林芝市 行政代码	数字	单个
林芝市 市花	百科实体	单个
林芝市 现任领导	人名	多个
林芝市 GDP	数字+单位	单个
林芝市 地区生产总值	数字+单位	单个
林芝市 市委书记	人名	单个
林芝市 人均生产总值	数字+单位	单个
林芝市 市长	人名	单个
大兴安岭地区 市花	百科实体	单个
大兴安岭地区 现任领导	人名	多个
大兴安岭地区 GDP	数字+单位	单个
大兴安岭地区 别名	其他	多个
大兴安岭地区 高等院校	地名	多个
大兴安岭地区 市委书记	人名	单个
大兴安岭地区 人均生产总值	数字+单位	单个
大兴安岭地区 市长	人名	单个
临汾市 市花	百科实体	单个
临汾市 现任领导	人名	多个
临汾市 GDP	数字+单位	单个
临汾市 高等院校	地名	多个
临汾市 市委书记	人名	单个
临汾市 人均生产总值	数字+单位	单个
临汾市 市长	人名	单个
崇左市 市花	百科实体	单个
崇左市 现任领导	人名	多个
崇左市 GDP	数字+单位	单个
崇左市 地区生产总值	数字+单位	单个
崇左市 高等院校	地名	多个
崇左市 市委书记	人名	单个
崇左市 人均生产总值	数字+单位	单个
岳阳市 行政代码	数字	单个
岳阳市 现任领导	人名	多个
岳阳市 GDP	数字+单位	单个
合肥市 GDP	数字+单位	单个
合肥市 地区生产总值	数字+单位	单个
合肥市 高等院校	地名	多个
铁岭市 现任领导	人名	多个
铁岭市 GDP	数字+单位	单个
铁岭市 地区生产总值	数字+单位	单个
铁岭市 高等院校	地名	多个
铁岭市 人均生产总值	数字+单位	单个
通辽市 行政代码	数字	单个
通辽市 市花	百科实体	单个
通辽市 现任领导	人名	多个
通辽市 GDP	数字+单位	单个
通辽市 市委书记	人名	单个
通辽市 市长	人名	单个
揭阳市 行政代码	数字	单个
揭阳市 现任领导	人名	多个
揭阳市 地区生产总值	数字+单位	单个
揭阳市 高等院校	地名	多个
揭阳市 人均生产总值	数字+单位	单个
本溪市 地区生产总值	数字+单位	单个
本溪市 高等院校	地名	多个
本溪市 人均生产总值	数字+单位	单个
西安市 行政代码	数字	单个
西安市 GDP	数字+单位	单个
西安市 地区生产总值	数字+单位	单个
西安市 高等院校	地名	多个
大理白族自治州 市花	百科实体	单个
大理白族自治州 现任领导	人名	多个
大理白族自治州 地区生产总值	数字+单位	单个
大理白族自治州 别名	其他	多个
大理白族自治州 高等院校	地名	多个
大理白族自治州 市委书记	人名	单个
大理白族自治州 人均生产总值	数字+单位	单个
大理白族自治州 市长	人名	单个
喀什地区 行政代码	数字	单个
喀什地区 市花	百科实体	单个
喀什地区 现任领导	人名	多个
喀什地区 GDP	数字+单位	单个
喀什地区 地区生产总值	数字+单位	单个
喀什地区 高等院校	地名	多个
喀什地区 市委书记	人名	单个
喀什地区 人均生产总值	数字+单位	单个
喀什地区 市长	人名	单个
四平市 市花	百科实体	单个
四平市 现任领导	人名	多个
四平市 地区生产总值	数字+单位	单个
四平市 高等院校	地名	多个
四平市 市委书记	人名	单个
四平市 人均生产总值	数字+单位	单个
四平市 市长	人名	单个
三亚市 行政代码	数字	单个
三亚市 GDP	数字+单位	单个
三亚市 高等院校	地名	多个
三亚市 人均生产总值	数字+单位	单个
梧州市 现任领导	人名	多个
梧州市 GDP	数字+单位	单个
梧州市 地区生产总值	数字+单位	单个
梧州市 人均生产总值	数字+单位	单个
雅安市 市花	百科实体	单个
雅安市 GDP	数字+单位	单个
雅安市 高等院校	地名	多个
德阳市 现任领导	人名	多个
德阳市 GDP	数字+单位	单个
德阳市 高等院校	地名	多个
德阳市 市委书记	人名	单个
德阳市 市长	人名	单个
三沙市 行政代码	数字	单个
三沙市 火车站	百科实体	多个
三沙市 市花	百科实体	单个
三沙市 现任领导	人名	多个
三沙市 GDP	数字+单位	单个
三沙市 地区生产总值	数字+单位	单个
三沙市 高等院校	地名	多个
三沙市 人均生产总值	数字+单位	单个
黄冈市 市花	百科实体	单个
黄冈市 现任领导	人名	多个
黄冈市 GDP	数字+单位	单个
黄冈市 人均生产总值	数字+单位	单个
滨州市 外文名称	其他	单个
滨州市 市花	百科实体	单个
滨州市 现任领导	人名	多个
滨州市 地区生产总值	数字+单位	单个
滨州市 别名	其他	多个
滨州市 高等院校	地名	多个
滨州市 人均生产总值	数字+单位	单个
通化市 现任领导	人名	多个
通化市 GDP	数字+单位	单个
通化市 地区生产总值	数字+单位	单个
通化市 高等院校	地名	多个
通化市 人均生产总值	数字+单位	单个
锡林郭勒盟 行政代码	数字	单个
锡林郭勒盟 市花	百科实体	单个
锡林郭勒盟 现任领导	人名	多个
锡林郭勒盟 GDP	数字+单位	单个
锡林郭勒盟 高等院校	地名	多个
锡林郭勒盟 市委书记	人名	单个
锡林郭勒盟 市长	人名	单个
抚顺市 行政代码	数字	单个
抚顺市 GDP	数字+单位	单个
抚顺市 高等院校	地名	多个
抚顺市 人均生产总值	数字+单位	单个
赤峰市 行政代码	数字	单个
赤峰市 市花	百科实体	单个
赤峰市 现任领导	人名	多个
赤峰市 GDP	数字+单位	单个
赤峰市 市委书记	人名	单个
赤峰市 市长	人名	单个
沧州市 市花	百科实体	单个
沧州市 GDP	数字+单位	单个
沧州市 机场	百科实体	单个
沧州市 人均生产总值	数字+单位	单个
北京市 GDP	数字+单位	单个
北京市 高等院校	地名	多个
巴彦淖尔市 行政代码	数字	单个
巴彦淖尔市 市花	百科实体	单个
巴彦淖尔市 现任领导	人名	多个
巴彦淖尔市 GDP	数字+单位	单个
巴彦淖尔市 高等院校	地名	多个
巴彦淖尔市 市委书记	人名	单个
巴彦淖尔市 人均生产总值	数字+单位	单个
泰州市 现任领导	人名	多个
泰州市 地区生产总值	数字+单位	单个
泰州市 人均生产总值	数字+单位	单个
枣庄市 行政代码	数字	单个
枣庄市 现任领导	人名	多个
枣庄市 GDP	数字+单位	单个
枣庄市 地区生产总值	数字+单位	单个
枣庄市 高等院校	地名	多个
枣庄市 市委书记	人名	单个
枣庄市 人均生产总值	数字+单位	单个
枣庄市 市长	人名	单个
红河哈尼族彝族自治州 市花	百科实体	单个
红河哈尼族彝族自治州 现任领导	人名	多个
红河哈尼族彝族自治州 地区生产总值	数字+单位	单个
红河哈尼族彝族自治州 别名	其他	多个
红河哈尼族彝族自治州 高等院校	地名	多个
红河哈尼族彝族自治州 市委书记	人名	单个
红河哈尼族彝族自治州 人均生产总值	数字+单位	单个
红河哈尼族彝族自治州 市长	人名	单个
常州市 现任领导	人名	多个
常州市 地区生产总值	数字+单位	单个
常州市 市委书记	人名	单个
常州市 人均生产总值	数字+单位	单个
常州市 市长	人名	单个
无锡市 市花	百科实体	单个
无锡市 GDP	数字+单位	单个
无锡市 高等院校	地名	多个
保定市 行政代码	数字	单个
保定市 GDP	数字+单位	单个
保定市 地区生产总值	数字+单位	单个
保定市 人均生产总值	数字+单位	单个
宜昌市 行政代码	数字	单个
宜昌市 GDP	数字+单位	单个
宜昌市 人均生产总值	数字+单位	单个
克拉玛依市 市花	百科实体	单个
克拉玛依市 现任领导	人名	多个
克拉玛依市 GDP	数字+单位	单个
克拉玛依市 市委书记	人名	单个
克拉玛依市 市长	人名	单个
萍乡市 GDP	数字+单位	单个
萍乡市 地区生产总值	数字+单位	单个
萍乡市 高等院校	地名	多个
萍乡市 人均生产总值	数字+单位	单个
泸州市 现任领导	人名	多个
泸州市 GDP	数字+单位	单个
泸州市 高等院校	地名	多个
保山市 现任领导	人名	多个
保山市 GDP	数字+单位	单个
保山市 地区生产总值	数字+单位	单个
保山市 高等院校	地名	多个
保山市 市委书记	人名	单个
保山市 人均生产总值	数字+单位	单个
保山市 市长	人名	单个
佛山市 现任领导	人名	多个
佛山市 GDP	数字+单位	单个
黔东南苗族侗族自治州 市花	百科实体	单个
黔东南苗族侗族自治州 现任领导	人名	多个
黔东南苗族侗族自治州 GDP	数字+单位	单个
黔东南苗族侗族自治州 地区生产总值	数字+单位	单个
黔东南苗族侗族自治州 市委书记	人名	单个
黔东南苗族侗族自治州 人均生产总值	数字+单位	单个
黔东南苗族侗族自治州 市长	人名	单个
安顺市 现任领导	人名	多个
安顺市 地区生产总值	数字+单位	单个
安顺市 别名	其他	多个
安顺市 高等院校	地名	多个
安顺市 市委书记	人名	单个
安顺市 人均生产总值	数字+单位	单个
安顺市 市长	人名	单个
南宁市 现任领导	人名	多个
南宁市 GDP	数字+单位	单个
南宁市 高等院校	地名	多个
南宁市 人均生产总值	数字+单位	单个
绍兴市 现任领导	人名	多个
绍兴市 地区生产总值	数字+单位	单个
绍兴市 市委书记	人名	单个
绍兴市 人均生产总值	数字+单位	单个
绍兴市 市长	人名	单个
齐齐哈尔市 行政代码	数字	单个
齐齐哈尔市 GDP	数字+单位	单个
齐齐哈尔市 高等院校	地名	多个
齐齐哈尔市 人均生产总值	数字+单位	单个
孝感市 市花	百科实体	单个
孝感市 现任领导	人名	多个
孝感市 GDP	数字+单位	单个
孝感市 地区生产总值	数字+单位	单个
孝感市 人均生产总值	数字+单位	单个
乌海市 行政代码	数字	单个
乌海市 市花	百科实体	单个
乌海市 现任领导	人名	多个
乌海市 GDP	数字+单位	单个
乌海市 高等院校	地名	多个
大同市 现任领导	人名	多个
大同市 地区生产总值	数字+单位	单个
大同市 高等院校	地名	多个
大同市 人均生产总值	数字+单位	单个
昭通市 市花	百科实体	单个
昭通市 现任领导	人名	多个
昭通市 地区生产总值	数字+单位	单个
昭通市 市委书记	人名	单个
昭通市 人均生产总值	数字+单位	单个
昭通市 市长	人名	单个
海南藏族自治州 行政代码	数字	单个
海南藏族自治州 火车站	百科实体	多个
海南藏族自治州 市花	百科实体	单个
海南藏族自治州 现任领导	人名	多个
海南藏族自治州 GDP	数字+单位	单个
海南藏族自治州 地区生产总值	数字+单位	单个
海南藏族自治州 高等院校	地名	多个
海南藏族自治州 市委书记	人名	单个
海南藏族自治州 人均生产总值	数字+单位	单个
海南藏族自治州 市长	人名	单个
葫芦岛市 行政代码	数字	单个
葫芦岛市 市花	百科实体	单个
葫芦岛市 现任领导	人名	多个
葫芦岛市 地区生产总值	数字+单位	单个
葫芦岛市 高等院校	地名	多个
葫芦岛市 市委书记	人名	单个
葫芦岛市 人均生产总值	数字+单位	单个
北海市 现任领导	人名	多个
北海市 地区生产总值	数字+单位	单个
北海市 高等院校	地名	多个
北海市 市委书记	人名	单个
北海市 人均生产总值	数字+单位	单个
北海市 市长	人名	单个
唐山市 行政代码	数字	单个
唐山市 现任领导	人名	多个
唐山市 GDP	数字+单位	单个
唐山市 地区生产总值	数字+单位	单个
唐山市 高等院校	地名	多个
唐山市 人均生产总值	数字+单位	单个
阳泉市 市花	百科实体	单个
阳泉市 现任领导	人名	多个
阳泉市 地区生产总值	数字+单位	单个
阳泉市 高等院校	地名	多个
阳泉市 人均生产总值	数字+单位	单个
文山壮族苗族自治州 市花	百科实体	单个
文山壮族苗族自治州 现任领导	人名	多个
文山壮族苗族自治州 GDP	数字+单位	单个
文山壮族苗族自治州 地区生产总值	数字+单位	单个
文山壮族苗族自治州 别名	其他	多个
文山壮族苗族自治州 市委书记	人名	单个
文山壮族苗族自治州 人均生产总值	数字+单位	单个
文山壮族苗族自治州 市长	人名	单个
十堰市 地区生产总值	数字+单位	单个
十堰市 人均生产总值	数字+单位	单个
云浮市 市花	百科实体	单个
云浮市 地区生产总值	数字+单位	单个
云浮市 高等院校	地名	多个
云浮市 人均生产总值	数字+单位	单个
自贡市 现任领导	人名	多个
自贡市 GDP	数字+单位	单个
自贡市 高等院校	地名	多个
自贡市 市委书记	人名	单个
自贡市 市长	人名	单个
海口市 行政代码	数字	单个
海口市 现任领导	人名	多个
海口市 地区生产总值	数字+单位	单个
海口市 高等院校	地名	多个
海口市 人均生产总值	数字+单位	单个
九江市 现任领导	人名	多个
九江市 GDP	数字+单位	单个
西双版纳傣族自治州 现任领导	人名	多个
西双版纳傣族自治州 地区生产总值	数字+单位	单个
西双版纳傣族自治州 高等院校	地名	多个
西双版纳傣族自治州 市委书记	人名	单个
西双版纳傣族自治州 人均生产总值	数字+单位	单个
西双版纳傣族自治州 市长	人名	单个
邵阳市 市花	百科实体	单个
邵阳市 GDP	数字+单位	单个
邵阳市 高等院校	地名	多个
凉山彝族自治州 市花	百科实体	单个
凉山彝族自治州 现任领导	人名	多个
凉山彝族自治州 GDP	数字+单位	单个
凉山彝族自治州 高等院校	地名	多个
凉山彝族自治州 市委书记	人名	单个
凉山彝族自治州 市长	人名	单个
黔西南布依族苗族自治州 市花	百科实体	单个
黔西南布依族苗族自治州 现任领导	人名	多个
黔西南布依族苗族自治州 GDP	数字+单位	单个
黔西南布依族苗族自治州 地区生产总值	数字+单位	单个
黔西南布依族苗族自治州 高等院校	地名	多个
黔西南布依族苗族自治州 市委书记	人名	单个
黔西南布依族苗族自治州 人均生产总值	数字+单位	单个
黔西南布依族苗族自治州 市长	人名	单个
朝阳市 市花	百科实体	单个
朝阳市 GDP	数字+单位	单个
朝阳市 高等院校	地名	多个
朝阳市 市委书记	人名	单个
朝阳市 市长	人名	单个
武威市 市花	百科实体	单个
武威市 现任领导	人名	多个
武威市 地区生产总值	数字+单位	单个
武威市 市委书记	人名	单个
武威市 人均生产总值	数字+单位	单个
嘉兴市 行政代码	数字	单个
嘉兴市 现任领导	人名	多个
嘉兴市 地区生产总值	数字+单位	单个
嘉兴市 高等院校	地名	多个
嘉兴市 市委书记	人名	单个
嘉兴市 人均生产总值	数字+单位	单个
铜川市 行政代码	数字	单个
铜川市 现任领导	人名	多个
铜川市 地区生产总值	数字+单位	单个
铜川市 高等院校	地名	多个
铜川市 市委书记	人名	单个
铜川市 人均生产总值	数字+单位	单个
铜川市 市长	人名	单个
淮北市 现任领导	人名	多个
淮北市 GDP	数字+单位	单个
淮北市 市委书记	人名	单个
淮北市 人均生产总值	数字+单位	单个
杭州市 现任领导	人名	多个
杭州市 GDP	数字+单位	单个
杭州市 高等院校	地名	多个
周口市 市花	百科实体	单个
周口市 现任领导	人名	多个
周口市 GDP	数字+单位	单个
周口市 地区生产总值	数字+单位	单个
周口市 高等院校	地名	多个
周口市 市委书记	人名	单个
周口市 人均生产总值	数字+单位	单个
怒江傈僳族自治州 火车站	百科实体	多个
怒江傈僳族自治州 市花	百科实体	单个
怒江傈僳族自治州 现任领导	人名	多个
怒江傈僳族自治州 GDP	数字+单位	单个
怒江傈僳族自治州 地区生产总值	数字+单位	单个
怒江傈僳族自治州 机场	百科实体	单个
怒江傈僳族自治州 高等院校	地名	多个
怒江傈僳族自治州 市委书记	人名	单个
怒江傈僳族自治州 人均生产总值	数字+单位	单个
怒江傈僳族自治州 市长	人名	单个
盘锦市 行政代码	数字	单个
盘锦市 现任领导	人名	多个
盘锦市 地区生产总值	数字+单位	单个
盘锦市 机场	百科实体	单个
盘锦市 高等院校	地名	多个
盘锦市 人均生产总值	数字+单位	单个
来宾市 市花	百科实体	单个
来宾市 现任领导	人名	多个
来宾市 GDP	数字+单位	单个
来宾市 地区生产总值	数字+单位	单个
来宾市 人均生产总值	数字+单位	单个
潍坊市 行政代码	数字	单个
潍坊市 现任领导	人名	多个
潍坊市 GDP	数字+单位	单个
潍坊市 高等院校	地名	多个
益阳市 行政代码	数字	单个
益阳市 现任领导	人名	多个
益阳市 GDP	数字+单位	单个
益阳市 市委书记	人名	单个
益阳市 市长	人名	单个
莱芜市 市花	百科实体	单个
莱芜市 现任领导	人名	多个
莱芜市 GDP	数字+单位	单个
莱芜市 机场	百科实体	单个
莱芜市 高等院校	地名	多个
莱芜市 市委书记	人名	单个
莱芜市 市长	人名	单个
蚌埠市 现任领导	人名	多个
蚌埠市 地区生产总值	数字+单位	单个
蚌埠市 高等院校	地名	多个
蚌埠市 人均生产总值	数字+单位	单个
日照市 市花	百科实体	单个
日照市 现任领导	人名	多个
日照市 GDP	数字+单位	单个
日照市 高等院校	地名	多个
日照市 人均生产总值	数字+单位	单个
中山市 现任领导	人名	多个
中山市 GDP	数字+单位	单个
中山市 地区生产总值	数字+单位	单个
中山市 机场	百科实体	单个
中山市 高等院校	地名	多个
中山市 人均生产总值	数字+单位	单个
中山市 市长	人名	单个
淮安市 行政代码	数字	单个
淮安市 现任领导	人名	多个
淮安市 地区生产总值	数字+单位	单个
淮安市 高等院校	地名	多个
淮安市 市委书记	人名	单个
淮安市 人均生产总值	数字+单位	单个
淮安市 市长	人名	单个
攀枝花市 现任领导	人名	多个
攀枝花市 GDP	数字+单位	单个
攀枝花市 市委书记	人名	单个
攀枝花市 市长	人名	单个
眉山市 行政代码	数字	单个
眉山市 市花	百科实体	单个
眉山市 GDP	数字+单位	单个
眉山市 高等院校	地名	多个
龙岩市 行政代码	数字	单个
龙岩市 现任领导	人名	多个
龙岩市 GDP	数字+单位	单个
昆明市 现任领导	人名	多个
昆明市 地区生产总值	数字+单位	单个
昆明市 高等院校	地名	多个
昆明市 市委书记	人名	单个
昆明市 人均生产总值	数字+单位	单个
昆明市 市长	人名	单个
锦州市 行政代码	数字	单个
锦州市 GDP	数字+单位	单个
锦州市 高等院校	地名	多个
锦州市 人均生产总值	数字+单位	单个
惠州市 行政代码	数字	单个
惠州市 现任领导	人名	多个
惠州市 GDP	数字+单位	单个
惠州市 市委书记	人名	单个
惠州市 市长	人名	单个
丽江市 市花	百科实体	单个
丽江市 现任领导	人名	多个
丽江市 GDP	数字+单位	单个
丽江市 地区生产总值	数字+单位	单个
丽江市 别名	其他	多个
丽江市 高等院校	地名	多个
丽江市 人均生产总值	数字+单位	单个
太原市 现任领导	人名	多个
太原市 地区生产总值	数字+单位	单个
太原市 高等院校	地名	多个
太原市 人均生产总值	数字+单位	单个
那曲地区 市花	百科实体	单个
那曲地区 现任领导	人名	多个
那曲地区 GDP	数字+单位	单个
那曲地区 地区生产总值	数字+单位	单个
那曲地区 高等院校	地名	多个
那曲地区 市委书记	人名	单个
那曲地区 人均生产总值	数字+单位	单个
那曲地区 市长	人名	单个
宣城市 GDP	数字+单位	单个
宣城市 高等院校	地名	多个
宣城市 人均生产总值	数字+单位	单个
南充市 现任领导	人名	多个
南充市 地区生产总值	数字+单位	单个
南充市 高等院校	地名	多个
南充市 人均生产总值	数字+单位	单个
贵港市 行政代码	数字	单个
贵港市 市花	百科实体	单个
贵港市 现任领导	人名	多个
贵港市 地区生产总值	数字+单位	单个
贵港市 机场	百科实体	单个
贵港市 高等院校	地名	多个
贵港市 市委书记	人名	单个
贵港市 人均生产总值	数字+单位	单个
贵港市 市长	人名	单个
咸阳市 行政代码	数字	单个
咸阳市 市花	百科实体	单个
咸阳市 现任领导	人名	多个
咸阳市 地区生产总值	数字+单位	单个
咸阳市 别名	其他	多个
咸阳市 高等院校	地名	多个
咸阳市 市委书记	人名	单个
咸阳市 人均生产总值	数字+单位	单个
咸阳市 市长	人名	单个
鞍山市 GDP	数字+单位	单个
黄南藏族自治州 行政代码	数字	单个
黄南藏族自治州 火车站	百科实体	多个
黄南藏族自治州 市花	百科实体	单个
黄南藏族自治州 现任领导	人名	多个
黄南藏族自治州 GDP	数字+单位	单个
黄南藏族自治州 地区生产总值	数字+单位	单个
黄南藏族自治州 别名	其他	多个
黄南藏族自治州 机场	百科实体	单个
黄南藏族自治州 高等院校	地名	多个
黄南藏族自治州 市委书记	人名	单个
黄南藏族自治州 人均生产总值	数字+单位	单个
黄南藏族自治州 市长	人名	单个
永州市 行政代码	数字	单个
永州市 市花	百科实体	单个
永州市 GDP	数字+单位	单个
永州市 高等院校	地名	多个
永州市 人均生产总值	数字+单位	单个
汕头市 现任领导	人名	多个
汕头市 GDP	数字+单位	单个
汕头市 市委书记	人名	单个
汕头市 市长	人名	单个
宜宾市 现任领导	人名	多个
宜宾市 GDP	数字+单位	单个
宁波市 现任领导	人名	多个
宁波市 地区生产总值	数字+单位	单个
宁波市 高等院校	地名	多个
宁波市 人均生产总值	数字+单位	单个
宁波市 市长	人名	单个
清远市 现任领导	人名	多个
清远市 地区生产总值	数字+单位	单个
清远市 机场	百科实体	单个
清远市 高等院校	地名	多个
清远市 市委书记	人名	单个
清远市 人均生产总值	数字+单位	单个
清远市 市长	人名	单个
辽源市 GDP	数字+单位	单个
辽源市 地区生产总值	数字+单位	单个
辽源市 高等院校	地名	多个
辽源市 人均生产总值	数字+单位	单个
临沂市 行政代码	数字	单个
临沂市 GDP	数字+单位	单个
临沂市 高等院校	地名	多个
临沂市 人均生产总值	数字+单位	单个
上海市 现任领导	人名	多个
上海市 GDP	数字+单位	单个
上海市 高等院校	地名	多个
石嘴山市 市花	百科实体	单个
石嘴山市 现任领导	人名	多个
石嘴山市 GDP	数字+单位	单个
石嘴山市 别名	其他	多个
石嘴山市 高等院校	地名	多个
石嘴山市 市委书记	人名	单个
石嘴山市 市长	人名	单个
泉州市 行政代码	数字	单个
泉州市 现任领导	人名	多个
泉州市 地区生产总值	数字+单位	单个
泉州市 高等院校	地名	多个
泉州市 人均生产总值	数字+单位	单个
甘孜藏族自治州 市花	百科实体	单个
甘孜藏族自治州 现任领导	人名	多个
甘孜藏族自治州 GDP	数字+单位	单个
甘孜藏族自治州 高等院校	地名	多个
甘孜藏族自治州 市委书记	人名	单个
甘孜藏族自治州 市长	人名	单个
济宁市 行政代码	数字	单个
济宁市 市花	百科实体	单个
济宁市 现任领导	人名	多个
济宁市 GDP	数字+单位	单个
济宁市 高等院校	地名	多个
济宁市 市委书记	人名	单个
济宁市 人均生产总值	数字+单位	单个
济宁市 市长	人名	单个
玉树藏族自治州 市花	百科实体	单个
玉树藏族自治州 现任领导	人名	多个
玉树藏族自治州 GDP	数字+单位	单个
玉树藏族自治州 地区生产总值	数字+单位	单个
玉树藏族自治州 邮政区码	数字	单个
玉树藏族自治州 高等院校	地名	多个
玉树藏族自治州 市委书记	人名	单个
玉树藏族自治州 人均生产总值	数字+单位	单个
玉树藏族自治州 市长	人名	单个
中卫市 市花	百科实体	单个
中卫市 现任领导	人名	多个
中卫市 GDP	数字+单位	单个
中卫市 别名	其他	多个
广州市 GDP	数字+单位	单个
广州市 高等院校	地名	多个
广州市 人均生产总值	数字+单位	单个
衢州市 现任领导	人名	多个
衢州市 地区生产总值	数字+单位	单个
衢州市 高等院校	地名	多个
衢州市 市委书记	人名	单个
衢州市 人均生产总值	数字+单位	单个
衢州市 市长	人名	单个
滁州市 行政代码	数字	单个
滁州市 现任领导	人名	多个
滁州市 GDP	数字+单位	单个
滁州市 高等院校	地名	多个
滁州市 人均生产总值	数字+单位	单个
松原市 市花	百科实体	单个
松原市 现任领导	人名	多个
松原市 GDP	数字+单位	单个
松原市 地区生产总值	数字+单位	单个
松原市 高等院校	地名	多个
松原市 人均生产总值	数字+单位	单个
渭南市 市花	百科实体	单个
渭南市 现任领导	人名	多个
渭南市 地区生产总值	数字+单位	单个
渭南市 高等院校	地名	多个
渭南市 人均生产总值	数字+单位	单个
驻马店市 市花	百科实体	单个
驻马店市 现任领导	人名	多个
驻马店市 GDP	数字+单位	单个
驻马店市 地区生产总值	数字+单位	单个
驻马店市 高等院校	地名	多个
驻马店市 市长	人名	单个
兴安盟 行政代码	数字	单个
兴安盟 市花	百科实体	单个
兴安盟 现任领导	人名	多个
兴安盟 GDP	数字+单位	单个
兴安盟 地区生产总值	数字+单位	单个
兴安盟 别名	其他	多个
兴安盟 高等院校	地名	多个
兴安盟 市委书记	人名	单个
兴安盟 人均生产总值	数字+单位	单个
兴安盟 市长	人名	单个
青岛市 行政代码	数字	单个
青岛市 现任领导	人名	多个
青岛市 GDP	数字+单位	单个
青岛市 高等院校	地名	多个
青岛市 市委书记	人名	单个
青岛市 市长	人名	单个
上饶市 现任领导	人名	多个
上饶市 地区生产总值	数字+单位	单个
上饶市 邮政区码	数字	单个
上饶市 高等院校	地名	多个
上饶市 人均生产总值	数字+单位	单个
茂名市 现任领导	人名	多个
茂名市 地区生产总值	数字+单位	单个
茂名市 高等院校	地名	多个
茂名市 市委书记	人名	单个
茂名市 人均生产总值	数字+单位	单个
茂名市 市长	人名	单个
运城市 行政代码	数字	单个
运城市 现任领导	人名	多个
运城市 GDP	数字+单位	单个
运城市 地区生产总值	数字+单位	单个
运城市 高等院校	地名	多个
运城市 市委书记	人名	单个
运城市 人均生产总值	数字+单位	单个
运城市 市长	人名	单个
舟山市 行政代码	数字	单个
舟山市 火车站	百科实体	多个
舟山市 现任领导	人名	多个
舟山市 GDP	数字+单位	单个
舟山市 高等院校	地名	多个
舟山市 市委书记	人名	单个
舟山市 市长	人名	单个
池州市 行政代码	数字	单个
池州市 地区生产总值	数字+单位	单个
池州市 高等院校	地名	多个
池州市 人均生产总值	数字+单位	单个
张家界市 行政代码	数字	单个
张家界市 市花	百科实体	单个
张家界市 GDP	数字+单位	单个
张家界市 高等院校	地名	多个
张家界市 市委书记	人名	单个
固原市 市花	百科实体	单个
固原市 GDP	数字+单位	单个
固原市 高等院校	地名	多个
芜湖市 行政代码	数字	单个
芜湖市 GDP	数字+单位	单个
芜湖市 高等院校	地名	多个
毕节市 市花	百科实体	单个
毕节市 现任领导	人名	多个
毕节市 GDP	数字+单位	单个
毕节市 地区生产总值	数字+单位	单个
毕节市 市委书记	人名	单个
毕节市 人均生产总值	数字+单位	单个
毕节市 市长	人名	单个
鹤岗市 市花	百科实体	单个
鹤岗市 现任领导	人名	多个
鹤岗市 地区生产总值	数字+单位	单个
鹤岗市 高等院校	地名	多个
鹤岗市 人均生产总值	数字+单位	单个
郴州市 行政代码	数字	单个
郴州市 现任领导	人名	多个
郴州市 GDP	数字+单位	单个
郴州市 高等院校	地名	多个
南通市 地区生产总值	数字+单位	单个
南通市 高等院校	地名	多个
南通市 人均生产总值	数字+单位	单个
商丘市 行政代码	数字	单个
商丘市 GDP	数字+单位	单个
商丘市 地区生产总值	数字+单位	单个
商丘市 高等院校	地名	多个
商丘市 人均生产总值	数字+单位	单个
漳州市 行政代码	数字	单个
漳州市 现任领导	人名	多个
漳州市 地区生产总值	数字+单位	单个
漳州市 高等院校	地名	多个
漳州市 人均生产总值	数字+单位	单个
连云港市 GDP	数字+单位	单个
连云港市 高等院校	地名	多个
