普罗维登斯 火车站	百科实体	多个
普罗维登斯 下辖地区	数字+单位	多个
哥伦布 电话区号	数字	单个
哥伦布 著名景点	百科实体	多个
哥伦布 人口	数字+单位	单个
哥伦布 火车站	百科实体	多个
哥伦布 外文名称	其他	单个
哥伦布 中文名称	其他	单个
哥伦布 邮政区码	数字	单个
哥伦布 政府驻地	其他	单个
哥伦布 行政区类别	其他	单个
哥伦布 地理位置	其他	句子
哥伦布 气候条件	其他	句子
哥伦布 所属地区	其他	单个
哥伦布 面积	数字+单位	单个
哥伦布 别名	其他	多个
哥伦布 机场	百科实体	单个
哥伦布 方言	百科实体	单个
哥伦布 下辖地区	数字+单位	多个
哥伦布 市长	人名	单个
里士满 火车站	百科实体	多个
里士满 下辖地区	数字+单位	多个
突尼斯城 电话区号	数字	单个
突尼斯城 著名景点	百科实体	多个
突尼斯城 人口	数字+单位	单个
突尼斯城 火车站	百科实体	多个
突尼斯城 外文名称	其他	单个
突尼斯城 中文名称	其他	单个
突尼斯城 邮政区码	数字	单个
突尼斯城 政府驻地	其他	单个
突尼斯城 行政区类别	其他	单个
突尼斯城 地理位置	其他	句子
突尼斯城 气候条件	其他	句子
突尼斯城 所属地区	其他	单个
突尼斯城 面积	数字+单位	单个
突尼斯城 别名	其他	多个
突尼斯城 机场	百科实体	单个
突尼斯城 方言	百科实体	单个
突尼斯城 下辖地区	数字+单位	多个
突尼斯城 市长	人名	单个
东京 市长	人名	单个
里斯本 电话区号	数字	单个
里斯本 火车站	百科实体	多个
里斯本 邮政区码	数字	单个
里斯本 政府驻地	其他	单个
里斯本 地理位置	其他	句子
里斯本 别名	其他	多个
里斯本 下辖地区	数字+单位	多个
里斯本 市长	人名	单个
金边 火车站	百科实体	多个
金边 邮政区码	数字	单个
金边 政府驻地	其他	单个
金边 别名	其他	多个
利雅得 火车站	百科实体	多个
利雅得 政府驻地	其他	单个
利雅得 别名	其他	多个
利雅得 下辖地区	数字+单位	多个
利雅得 市长	人名	单个
巴西利亚 火车站	百科实体	多个
巴西利亚 政府驻地	其他	单个
巴西利亚 机场	百科实体	单个
巴西利亚 下辖地区	数字+单位	多个
布达佩斯 行政区类别	其他	单个
布达佩斯 地理位置	其他	句子
布达佩斯 方言	百科实体	单个
布达佩斯 市长	人名	单个
萨格勒布 邮政区码	数字	单个
萨格勒布 政府驻地	其他	单个
萨格勒布 行政区类别	其他	单个
萨格勒布 下辖地区	数字+单位	多个
萨格勒布 市长	人名	单个
伊斯兰堡 邮政区码	数字	单个
伊斯兰堡 别名	其他	多个
迪拜 火车站	百科实体	多个
迪拜 市长	人名	单个
阿布贾 电话区号	数字	单个
阿布贾 著名景点	百科实体	多个
阿布贾 火车站	百科实体	多个
阿布贾 邮政区码	数字	单个
阿布贾 政府驻地	其他	单个
阿布贾 机场	百科实体	单个
阿布贾 下辖地区	数字+单位	多个
阿布贾 市长	人名	单个
斯德哥尔摩 火车站	百科实体	多个
斯德哥尔摩 邮政区码	数字	单个
斯德哥尔摩 政府驻地	其他	单个
斯德哥尔摩 气候条件	其他	句子
斯德哥尔摩 下辖地区	数字+单位	多个
伯明翰 电话区号	数字	单个
伯明翰 政府驻地	其他	单个
伯明翰 行政区类别	其他	单个
伯明翰 下辖地区	数字+单位	多个
伯明翰 市长	人名	单个
吉隆坡 政府驻地	其他	单个
吉隆坡 市长	人名	单个
都林 电话区号	数字	单个
都林 著名景点	百科实体	多个
都林 人口	数字+单位	单个
都林 火车站	百科实体	多个
都林 外文名称	其他	单个
都林 中文名称	其他	单个
都林 邮政区码	数字	单个
都林 政府驻地	其他	单个
都林 行政区类别	其他	单个
都林 地理位置	其他	句子
都林 气候条件	其他	句子
都林 所属地区	其他	单个
都林 面积	数字+单位	单个
都林 别名	其他	多个
都林 机场	百科实体	单个
都林 方言	百科实体	单个
都林 下辖地区	数字+单位	多个
都林 市长	人名	单个
马拉加 电话区号	数字	单个
马拉加 火车站	百科实体	多个
马拉加 邮政区码	数字	单个
马拉加 政府驻地	其他	单个
马拉加 行政区类别	其他	单个
马拉加 地理位置	其他	句子
马拉加 面积	数字+单位	单个
马拉加 别名	其他	多个
马拉加 方言	百科实体	单个
马拉加 下辖地区	数字+单位	多个
马拉加 市长	人名	单个
圣保罗 电话区号	数字	单个
圣保罗 邮政区码	数字	单个
圣保罗 别名	其他	多个
圣保罗 下辖地区	数字+单位	多个
圣保罗 市长	人名	单个
华雷斯 火车站	百科实体	多个
华雷斯 邮政区码	数字	单个
华雷斯 政府驻地	其他	单个
华雷斯 别名	其他	多个
华雷斯 下辖地区	数字+单位	多个
华雷斯 市长	人名	单个
马德里 政府驻地	其他	单个
马德里 市长	人名	单个
泗水 方言	百科实体	单个
泗水 市长	人名	单个
海法 火车站	百科实体	多个
海法 外文名称	其他	单个
海法 邮政区码	数字	单个
海法 政府驻地	其他	单个
海法 别名	其他	多个
海法 机场	百科实体	单个
海法 下辖地区	数字+单位	多个
海法 市长	人名	单个
火奴鲁鲁 火车站	百科实体	多个
火奴鲁鲁 邮政区码	数字	单个
库里蒂巴 著名景点	百科实体	多个
库里蒂巴 火车站	百科实体	多个
库里蒂巴 政府驻地	其他	单个
库里蒂巴 行政区类别	其他	单个
库里蒂巴 地理位置	其他	句子
库里蒂巴 气候条件	其他	句子
库里蒂巴 别名	其他	多个
库里蒂巴 方言	百科实体	单个
库里蒂巴 下辖地区	数字+单位	多个
库里蒂巴 市长	人名	单个
赫尔辛基 电话区号	数字	单个
赫尔辛基 邮政区码	数字	单个
赫尔辛基 政府驻地	其他	单个
赫尔辛基 市长	人名	单个
卢布尔雅那 政府驻地	其他	单个
卢布尔雅那 下辖地区	数字+单位	多个
卢布尔雅那 市长	人名	单个
圣菲波哥大 电话区号	数字	单个
圣菲波哥大 邮政区码	数字	单个
圣菲波哥大 政府驻地	其他	单个
圣菲波哥大 别名	其他	多个
圣菲波哥大 下辖地区	数字+单位	多个
圣菲波哥大 市长	人名	单个
萨克拉门托 著名景点	百科实体	多个
萨克拉门托 政府驻地	其他	单个
萨克拉门托 方言	百科实体	单个
萨克拉门托 下辖地区	数字+单位	多个
哈特福德 电话区号	数字	单个
哈特福德 著名景点	百科实体	多个
哈特福德 火车站	百科实体	多个
哈特福德 邮政区码	数字	单个
哈特福德 政府驻地	其他	单个
哈特福德 地理位置	其他	句子
哈特福德 气候条件	其他	句子
哈特福德 面积	数字+单位	单个
哈特福德 别名	其他	多个
哈特福德 方言	百科实体	单个
哈特福德 下辖地区	数字+单位	多个
哈特福德 市长	人名	单个
贝尔法斯特 电话区号	数字	单个
贝尔法斯特 火车站	百科实体	多个
贝尔法斯特 邮政区码	数字	单个
贝尔法斯特 政府驻地	其他	单个
贝尔法斯特 面积	数字+单位	单个
贝尔法斯特 别名	其他	多个
贝尔法斯特 方言	百科实体	单个
贝尔法斯特 市长	人名	单个
魁北克 火车站	百科实体	多个
魁北克 市长	人名	单个
乌特勒支 电话区号	数字	单个
乌特勒支 人口	数字+单位	单个
乌特勒支 火车站	百科实体	多个
乌特勒支 邮政区码	数字	单个
乌特勒支 行政区类别	其他	单个
乌特勒支 气候条件	其他	句子
乌特勒支 面积	数字+单位	单个
乌特勒支 别名	其他	多个
乌特勒支 机场	百科实体	单个
乌特勒支 方言	百科实体	单个
乌特勒支 下辖地区	数字+单位	多个
乌特勒支 市长	人名	单个
里加 电话区号	数字	单个
里加 火车站	百科实体	多个
里加 邮政区码	数字	单个
里加 政府驻地	其他	单个
里加 别名	其他	多个
里加 方言	百科实体	单个
里加 下辖地区	数字+单位	多个
里加 市长	人名	单个
蒙得维的亚 电话区号	数字	单个
蒙得维的亚 著名景点	百科实体	多个
蒙得维的亚 火车站	百科实体	多个
蒙得维的亚 邮政区码	数字	单个
蒙得维的亚 政府驻地	其他	单个
蒙得维的亚 别名	其他	多个
蒙得维的亚 下辖地区	数字+单位	多个
蒙得维的亚 市长	人名	单个
蒙彼利埃 下辖地区	数字+单位	多个
蒙彼利埃 市长	人名	单个
丹佛 电话区号	数字	单个
丹佛 著名景点	百科实体	多个
丹佛 火车站	百科实体	多个
丹佛 邮政区码	数字	单个
丹佛 政府驻地	其他	单个
丹佛 气候条件	其他	句子
丹佛 下辖地区	数字+单位	多个
奥胡斯 电话区号	数字	单个
奥胡斯 著名景点	百科实体	多个
奥胡斯 火车站	百科实体	多个
奥胡斯 邮政区码	数字	单个
奥胡斯 政府驻地	其他	单个
奥胡斯 气候条件	其他	句子
奥胡斯 所属地区	其他	单个
奥胡斯 面积	数字+单位	单个
奥胡斯 别名	其他	多个
奥胡斯 机场	百科实体	单个
奥胡斯 下辖地区	数字+单位	多个
奥胡斯 市长	人名	单个
波尔多 下辖地区	数字+单位	多个
波尔多 市长	人名	单个
克利夫兰 电话区号	数字	单个
克利夫兰 著名景点	百科实体	多个
克利夫兰 人口	数字+单位	单个
克利夫兰 火车站	百科实体	多个
克利夫兰 外文名称	其他	单个
克利夫兰 中文名称	其他	单个
克利夫兰 邮政区码	数字	单个
克利夫兰 政府驻地	其他	单个
克利夫兰 行政区类别	其他	单个
克利夫兰 地理位置	其他	句子
克利夫兰 气候条件	其他	句子
克利夫兰 面积	数字+单位	单个
克利夫兰 别名	其他	多个
克利夫兰 机场	百科实体	单个
克利夫兰 方言	百科实体	单个
克利夫兰 下辖地区	数字+单位	多个
克利夫兰 市长	人名	单个
仰光 火车站	百科实体	多个
仰光 邮政区码	数字	单个
仰光 政府驻地	其他	单个
仰光 地理位置	其他	句子
仰光 下辖地区	数字+单位	多个
马那瓜 电话区号	数字	单个
马那瓜 著名景点	百科实体	多个
马那瓜 火车站	百科实体	多个
马那瓜 邮政区码	数字	单个
马那瓜 政府驻地	其他	单个
马那瓜 气候条件	其他	句子
马那瓜 面积	数字+单位	单个
马那瓜 别名	其他	多个
马那瓜 方言	百科实体	单个
马那瓜 下辖地区	数字+单位	多个
马那瓜 市长	人名	单个
卢萨卡 电话区号	数字	单个
卢萨卡 火车站	百科实体	多个
卢萨卡 邮政区码	数字	单个
卢萨卡 政府驻地	其他	单个
卢萨卡 气候条件	其他	句子
卢萨卡 面积	数字+单位	单个
卢萨卡 方言	百科实体	单个
卢萨卡 下辖地区	数字+单位	多个
卢萨卡 市长	人名	单个
塔什干 火车站	百科实体	多个
塔什干 邮政区码	数字	单个
塔什干 下辖地区	数字+单位	多个
塔什干 市长	人名	单个
阿布扎比 火车站	百科实体	多个
阿布扎比 邮政区码	数字	单个
阿布扎比 市长	人名	单个
圣地亚哥 电话区号	数字	单个
圣地亚哥 邮政区码	数字	单个
圣地亚哥 政府驻地	其他	单个
圣地亚哥 别名	其他	多个
圣地亚哥 下辖地区	数字+单位	多个
圣地亚哥 市长	人名	单个
约翰内斯堡 火车站	百科实体	多个
约翰内斯堡 邮政区码	数字	单个
约翰内斯堡 下辖地区	数字+单位	多个
约翰内斯堡 市长	人名	单个
芝加哥 政府驻地	其他	单个
芝加哥 下辖地区	数字+单位	多个
基加利 著名景点	百科实体	多个
基加利 火车站	百科实体	多个
基加利 邮政区码	数字	单个
基加利 政府驻地	其他	单个
基加利 行政区类别	其他	单个
基加利 气候条件	其他	句子
基加利 面积	数字+单位	单个
基加利 别名	其他	多个
基加利 方言	百科实体	单个
基加利 下辖地区	数字+单位	多个
基加利 市长	人名	单个
开罗 邮政区码	数字	单个
开罗 政府驻地	其他	单个
开罗 下辖地区	数字+单位	多个
开罗 市长	人名	单个
里约热内卢 政府驻地	其他	单个
里约热内卢 市长	人名	单个
达拉斯 电话区号	数字	单个
达拉斯 火车站	百科实体	多个
达拉斯 邮政区码	数字	单个
达拉斯 政府驻地	其他	单个
达拉斯 别名	其他	多个
达拉斯 下辖地区	数字+单位	多个
达拉斯 市长	人名	单个
亚特兰大 火车站	百科实体	多个
亚特兰大 政府驻地	其他	单个
亚特兰大 气候条件	其他	句子
亚特兰大 别名	其他	多个
亚特兰大 方言	百科实体	单个
波尔图 电话区号	数字	单个
波尔图 著名景点	百科实体	多个
波尔图 人口	数字+单位	单个
波尔图 火车站	百科实体	多个
波尔图 外文名称	其他	单个
波尔图 中文名称	其他	单个
波尔图 邮政区码	数字	单个
波尔图 政府驻地	其他	单个
波尔图 行政区类别	其他	单个
波尔图 地理位置	其他	句子
波尔图 气候条件	其他	句子
波尔图 面积	数字+单位	单个
波尔图 别名	其他	多个
波尔图 机场	百科实体	单个
波尔图 方言	百科实体	单个
波尔图 下辖地区	数字+单位	多个
波尔图 市长	人名	单个
阿瓜斯卡连特斯 电话区号	数字	单个
阿瓜斯卡连特斯 著名景点	百科实体	多个
阿瓜斯卡连特斯 人口	数字+单位	单个
阿瓜斯卡连特斯 火车站	百科实体	多个
阿瓜斯卡连特斯 邮政区码	数字	单个
阿瓜斯卡连特斯 政府驻地	其他	单个
阿瓜斯卡连特斯 气候条件	其他	句子
阿瓜斯卡连特斯 面积	数字+单位	单个
阿瓜斯卡连特斯 别名	其他	多个
阿瓜斯卡连特斯 机场	百科实体	单个
阿瓜斯卡连特斯 方言	百科实体	单个
阿瓜斯卡连特斯 下辖地区	数字+单位	多个
阿瓜斯卡连特斯 市长	人名	单个
布宜诺斯艾利斯 下辖地区	数字+单位	多个
布宜诺斯艾利斯 市长	人名	单个
基多 电话区号	数字	单个
基多 火车站	百科实体	多个
基多 邮政区码	数字	单个
基多 政府驻地	其他	单个
基多 气候条件	其他	句子
基多 所属地区	其他	单个
基多 别名	其他	多个
基多 下辖地区	数字+单位	多个
基多 市长	人名	单个
科尔多瓦 著名景点	百科实体	多个
科尔多瓦 邮政区码	数字	单个
科尔多瓦 政府驻地	其他	单个
科尔多瓦 气候条件	其他	句子
科尔多瓦 面积	数字+单位	单个
科尔多瓦 别名	其他	多个
科尔多瓦 机场	百科实体	单个
科尔多瓦 方言	百科实体	单个
科尔多瓦 下辖地区	数字+单位	多个
科尔多瓦 市长	人名	单个
索菲亚 电话区号	数字	单个
索菲亚 著名景点	百科实体	多个
索菲亚 人口	数字+单位	单个
索菲亚 火车站	百科实体	多个
索菲亚 外文名称	其他	单个
索菲亚 中文名称	其他	单个
索菲亚 邮政区码	数字	单个
索菲亚 政府驻地	其他	单个
索菲亚 行政区类别	其他	单个
索菲亚 地理位置	其他	句子
索菲亚 气候条件	其他	句子
索菲亚 所属地区	其他	单个
索菲亚 面积	数字+单位	单个
索菲亚 别名	其他	多个
索菲亚 机场	百科实体	单个
索菲亚 方言	百科实体	单个
索菲亚 下辖地区	数字+单位	多个
索菲亚 市长	人名	单个
乔治敦 电话区号	数字	单个
乔治敦 火车站	百科实体	多个
乔治敦 邮政区码	数字	单个
乔治敦 政府驻地	其他	单个
乔治敦 气候条件	其他	句子
乔治敦 别名	其他	多个
乔治敦 机场	百科实体	单个
乔治敦 方言	百科实体	单个
乔治敦 下辖地区	数字+单位	多个
乔治敦 市长	人名	单个
俄克拉荷马城 电话区号	数字	单个
俄克拉荷马城 著名景点	百科实体	多个
俄克拉荷马城 火车站	百科实体	多个
俄克拉荷马城 邮政区码	数字	单个
俄克拉荷马城 政府驻地	其他	单个
俄克拉荷马城 别名	其他	多个
坎帕拉 电话区号	数字	单个
坎帕拉 火车站	百科实体	多个
坎帕拉 邮政区码	数字	单个
坎帕拉 政府驻地	其他	单个
坎帕拉 气候条件	其他	句子
坎帕拉 别名	其他	多个
坎帕拉 市长	人名	单个
金沙萨 电话区号	数字	单个
金沙萨 邮政区码	数字	单个
金沙萨 市长	人名	单个
纳西克 电话区号	数字	单个
纳西克 著名景点	百科实体	多个
纳西克 火车站	百科实体	多个
纳西克 外文名称	其他	单个
纳西克 邮政区码	数字	单个
纳西克 政府驻地	其他	单个
纳西克 行政区类别	其他	单个
纳西克 气候条件	其他	句子
纳西克 所属地区	其他	单个
纳西克 别名	其他	多个
纳西克 机场	百科实体	单个
纳西克 方言	百科实体	单个
纳西克 下辖地区	数字+单位	多个
纳西克 市长	人名	单个
那格浦尔 电话区号	数字	单个
那格浦尔 火车站	百科实体	多个
那格浦尔 邮政区码	数字	单个
那格浦尔 政府驻地	其他	单个
那格浦尔 行政区类别	其他	单个
那格浦尔 气候条件	其他	句子
那格浦尔 别名	其他	多个
那格浦尔 机场	百科实体	单个
那格浦尔 方言	百科实体	单个
那格浦尔 市长	人名	单个
卡尔加里 邮政区码	数字	单个
卡尔加里 下辖地区	数字+单位	多个
塞维利亚 电话区号	数字	单个
塞维利亚 著名景点	百科实体	多个
塞维利亚 人口	数字+单位	单个
塞维利亚 火车站	百科实体	多个
塞维利亚 外文名称	其他	单个
塞维利亚 中文名称	其他	单个
塞维利亚 邮政区码	数字	单个
塞维利亚 政府驻地	其他	单个
塞维利亚 行政区类别	其他	单个
塞维利亚 地理位置	其他	句子
塞维利亚 气候条件	其他	句子
塞维利亚 所属地区	其他	单个
塞维利亚 面积	数字+单位	单个
塞维利亚 别名	其他	多个
塞维利亚 机场	百科实体	单个
塞维利亚 方言	百科实体	单个
塞维利亚 下辖地区	数字+单位	多个
塞维利亚 市长	人名	单个
印第安纳波利斯 电话区号	数字	单个
印第安纳波利斯 著名景点	百科实体	多个
印第安纳波利斯 火车站	百科实体	多个
印第安纳波利斯 邮政区码	数字	单个
印第安纳波利斯 政府驻地	其他	单个
印第安纳波利斯 行政区类别	其他	单个
印第安纳波利斯 地理位置	其他	句子
印第安纳波利斯 气候条件	其他	句子
印第安纳波利斯 别名	其他	多个
印第安纳波利斯 方言	百科实体	单个
印第安纳波利斯 市长	人名	单个
利马索尔 电话区号	数字	单个
利马索尔 著名景点	百科实体	多个
利马索尔 火车站	百科实体	多个
利马索尔 邮政区码	数字	单个
利马索尔 政府驻地	其他	单个
利马索尔 地理位置	其他	句子
利马索尔 气候条件	其他	句子
利马索尔 所属地区	其他	单个
利马索尔 面积	数字+单位	单个
利马索尔 机场	百科实体	单个
利马索尔 方言	百科实体	单个
利马索尔 下辖地区	数字+单位	多个
利马索尔 市长	人名	单个
科威特城 电话区号	数字	单个
科威特城 著名景点	百科实体	多个
科威特城 火车站	百科实体	多个
科威特城 邮政区码	数字	单个
科威特城 政府驻地	其他	单个
科威特城 气候条件	其他	句子
科威特城 别名	其他	多个
科威特城 机场	百科实体	单个
科威特城 方言	百科实体	单个
科威特城 下辖地区	数字+单位	多个
科威特城 市长	人名	单个
利兹 电话区号	数字	单个
利兹 著名景点	百科实体	多个
利兹 政府驻地	其他	单个
利兹 气候条件	其他	句子
利兹 别名	其他	多个
利兹 方言	百科实体	单个
利兹 下辖地区	数字+单位	多个
利兹 市长	人名	单个
密尔沃基 政府驻地	其他	单个
林茨 电话区号	数字	单个
林茨 火车站	百科实体	多个
林茨 邮政区码	数字	单个
林茨 政府驻地	其他	单个
林茨 行政区类别	其他	单个
林茨 地理位置	其他	句子
林茨 气候条件	其他	句子
林茨 别名	其他	多个
林茨 机场	百科实体	单个
林茨 方言	百科实体	单个
林茨 下辖地区	数字+单位	多个
林茨 市长	人名	单个
圣胡安 电话区号	数字	单个
圣胡安 著名景点	百科实体	多个
圣胡安 火车站	百科实体	多个
圣胡安 外文名称	其他	单个
圣胡安 中文名称	其他	单个
圣胡安 邮政区码	数字	单个
圣胡安 政府驻地	其他	单个
圣胡安 行政区类别	其他	单个
圣胡安 地理位置	其他	句子
圣胡安 气候条件	其他	句子
圣胡安 所属地区	其他	单个
圣胡安 别名	其他	多个
圣胡安 机场	百科实体	单个
圣胡安 方言	百科实体	单个
圣胡安 下辖地区	数字+单位	多个
圣胡安 市长	人名	单个
马赛 政府驻地	其他	单个
马赛 别名	其他	多个
马赛 下辖地区	数字+单位	多个
马赛 市长	人名	单个
海得拉巴 政府驻地	其他	单个
海得拉巴 下辖地区	数字+单位	多个
亚松森 火车站	百科实体	多个
亚松森 邮政区码	数字	单个
亚松森 政府驻地	其他	单个
亚松森 别名	其他	多个
亚松森 下辖地区	数字+单位	多个
亚松森 市长	人名	单个
瓜达拉哈拉 电话区号	数字	单个
瓜达拉哈拉 火车站	百科实体	多个
瓜达拉哈拉 邮政区码	数字	单个
瓜达拉哈拉 政府驻地	其他	单个
瓜达拉哈拉 别名	其他	多个
瓜达拉哈拉 下辖地区	数字+单位	多个
瓜达拉哈拉 市长	人名	单个
加的夫 政府驻地	其他	单个
加的夫 行政区类别	其他	单个
加的夫 地理位置	其他	句子
加的夫 方言	百科实体	单个
加的夫 下辖地区	数字+单位	多个
加的夫 市长	人名	单个
图卢兹 电话区号	数字	单个
图卢兹 著名景点	百科实体	多个
图卢兹 火车站	百科实体	多个
图卢兹 外文名称	其他	单个
图卢兹 中文名称	其他	单个
图卢兹 邮政区码	数字	单个
图卢兹 政府驻地	其他	单个
图卢兹 行政区类别	其他	单个
图卢兹 地理位置	其他	句子
图卢兹 气候条件	其他	句子
图卢兹 所属地区	其他	单个
图卢兹 别名	其他	多个
图卢兹 机场	百科实体	单个
图卢兹 方言	百科实体	单个
图卢兹 下辖地区	数字+单位	多个
图卢兹 市长	人名	单个
巴塞罗那 电话区号	数字	单个
巴塞罗那 著名景点	百科实体	多个
巴塞罗那 人口	数字+单位	单个
巴塞罗那 火车站	百科实体	多个
巴塞罗那 外文名称	其他	单个
巴塞罗那 中文名称	其他	单个
巴塞罗那 邮政区码	数字	单个
巴塞罗那 政府驻地	其他	单个
巴塞罗那 行政区类别	其他	单个
巴塞罗那 地理位置	其他	句子
巴塞罗那 气候条件	其他	句子
巴塞罗那 面积	数字+单位	单个
巴塞罗那 别名	其他	多个
巴塞罗那 机场	百科实体	单个
巴塞罗那 方言	百科实体	单个
巴塞罗那 下辖地区	数字+单位	多个
巴塞罗那 市长	人名	单个
路易港 电话区号	数字	单个
路易港 著名景点	百科实体	多个
路易港 火车站	百科实体	多个
路易港 邮政区码	数字	单个
路易港 政府驻地	其他	单个
路易港 地理位置	其他	句子
路易港 别名	其他	多个
路易港 下辖地区	数字+单位	多个
路易港 市长	人名	单个
格勒诺布尔 电话区号	数字	单个
格勒诺布尔 著名景点	百科实体	多个
格勒诺布尔 火车站	百科实体	多个
格勒诺布尔 政府驻地	其他	单个
格勒诺布尔 气候条件	其他	句子
格勒诺布尔 所属地区	其他	单个
格勒诺布尔 别名	其他	多个
格勒诺布尔 机场	百科实体	单个
格勒诺布尔 方言	百科实体	单个
格勒诺布尔 下辖地区	数字+单位	多个
格勒诺布尔 市长	人名	单个
菲尼克斯 邮政区码	数字	单个
菲尼克斯 政府驻地	其他	单个
卢森堡 著名景点	百科实体	多个
卢森堡 火车站	百科实体	多个
卢森堡 外文名称	其他	单个
卢森堡 邮政区码	数字	单个
卢森堡 政府驻地	其他	单个
卢森堡 行政区类别	其他	单个
卢森堡 地理位置	其他	句子
卢森堡 气候条件	其他	句子
卢森堡 所属地区	其他	单个
卢森堡 别名	其他	多个
卢森堡 机场	百科实体	单个
卢森堡 方言	百科实体	单个
卢森堡 下辖地区	数字+单位	多个
卢森堡 市长	人名	单个
阿比让 著名景点	百科实体	多个
阿比让 火车站	百科实体	多个
阿比让 邮政区码	数字	单个
阿比让 政府驻地	其他	单个
阿比让 面积	数字+单位	单个
阿比让 别名	其他	多个
阿比让 机场	百科实体	单个
阿比让 市长	人名	单个
贝尔格莱德 火车站	百科实体	多个
贝尔格莱德 政府驻地	其他	单个
贝尔格莱德 方言	百科实体	单个
贝尔格莱德 市长	人名	单个
奥兰多 电话区号	数字	单个
奥兰多 火车站	百科实体	多个
奥兰多 邮政区码	数字	单个
奥兰多 政府驻地	其他	单个
奥兰多 气候条件	其他	句子
奥兰多 面积	数字+单位	单个
奥兰多 下辖地区	数字+单位	多个
奥兰多 市长	人名	单个
安曼 电话区号	数字	单个
安曼 火车站	百科实体	多个
安曼 邮政区码	数字	单个
安曼 政府驻地	其他	单个
安曼 地理位置	其他	句子
安曼 别名	其他	多个
安曼 机场	百科实体	单个
安曼 下辖地区	数字+单位	多个
安曼 市长	人名	单个
洛桑 电话区号	数字	单个
洛桑 著名景点	百科实体	多个
洛桑 人口	数字+单位	单个
洛桑 火车站	百科实体	多个
洛桑 外文名称	其他	单个
洛桑 中文名称	其他	单个
洛桑 邮政区码	数字	单个
洛桑 政府驻地	其他	单个
洛桑 行政区类别	其他	单个
洛桑 地理位置	其他	句子
洛桑 气候条件	其他	句子
洛桑 所属地区	其他	单个
洛桑 面积	数字+单位	单个
洛桑 机场	百科实体	单个
洛桑 方言	百科实体	单个
洛桑 下辖地区	数字+单位	多个
洛桑 市长	人名	单个
危地马拉城 电话区号	数字	单个
危地马拉城 著名景点	百科实体	多个
危地马拉城 人口	数字+单位	单个
危地马拉城 火车站	百科实体	多个
危地马拉城 邮政区码	数字	单个
危地马拉城 政府驻地	其他	单个
危地马拉城 行政区类别	其他	单个
危地马拉城 气候条件	其他	句子
危地马拉城 所属地区	其他	单个
危地马拉城 别名	其他	多个
危地马拉城 机场	百科实体	单个
危地马拉城 方言	百科实体	单个
危地马拉城 下辖地区	数字+单位	多个
危地马拉城 市长	人名	单个
卡萨布兰卡 电话区号	数字	单个
卡萨布兰卡 著名景点	百科实体	多个
卡萨布兰卡 人口	数字+单位	单个
卡萨布兰卡 火车站	百科实体	多个
卡萨布兰卡 外文名称	其他	单个
卡萨布兰卡 中文名称	其他	单个
卡萨布兰卡 邮政区码	数字	单个
卡萨布兰卡 政府驻地	其他	单个
卡萨布兰卡 行政区类别	其他	单个
卡萨布兰卡 地理位置	其他	句子
卡萨布兰卡 气候条件	其他	句子
卡萨布兰卡 所属地区	其他	单个
卡萨布兰卡 面积	数字+单位	单个
卡萨布兰卡 别名	其他	多个
卡萨布兰卡 机场	百科实体	单个
卡萨布兰卡 方言	百科实体	单个
卡萨布兰卡 下辖地区	数字+单位	多个
卡萨布兰卡 市长	人名	单个
布里斯托 火车站	百科实体	多个
布里斯托 下辖地区	数字+单位	多个
布里斯托 市长	人名	单个
列日 电话区号	数字	单个
列日 著名景点	百科实体	多个
列日 火车站	百科实体	多个
列日 邮政区码	数字	单个
列日 政府驻地	其他	单个
列日 气候条件	其他	句子
列日 别名	其他	多个
列日 机场	百科实体	单个
列日 方言	百科实体	单个
列日 下辖地区	数字+单位	多个
列日 市长	人名	单个
墨西卡利 电话区号	数字	单个
墨西卡利 著名景点	百科实体	多个
墨西卡利 人口	数字+单位	单个
墨西卡利 火车站	百科实体	多个
墨西卡利 邮政区码	数字	单个
墨西卡利 政府驻地	其他	单个
墨西卡利 面积	数字+单位	单个
墨西卡利 别名	其他	多个
墨西卡利 方言	百科实体	单个
墨西卡利 下辖地区	数字+单位	多个
墨西卡利 市长	人名	单个
曼彻斯特 市长	人名	单个
法兰克福 电话区号	数字	单个
法兰克福 火车站	百科实体	多个
法兰克福 邮政区码	数字	单个
法兰克福 政府驻地	其他	单个
法兰克福 下辖地区	数字+单位	多个
法兰克福 市长	人名	单个
克拉科夫 电话区号	数字	单个
克拉科夫 火车站	百科实体	多个
克拉科夫 邮政区码	数字	单个
克拉科夫 政府驻地	其他	单个
克拉科夫 地理位置	其他	句子
克拉科夫 面积	数字+单位	单个
克拉科夫 机场	百科实体	单个
克拉科夫 方言	百科实体	单个
克拉科夫 下辖地区	数字+单位	多个
克拉科夫 市长	人名	单个
斯科普里 著名景点	百科实体	多个
斯科普里 火车站	百科实体	多个
斯科普里 所属地区	其他	单个
斯科普里 别名	其他	多个
斯科普里 下辖地区	数字+单位	多个
杜塞尔多夫 火车站	百科实体	多个
杜塞尔多夫 下辖地区	数字+单位	多个
杜塞尔多夫 市长	人名	单个
曼谷 政府驻地	其他	单个
加尔各答 政府驻地	其他	单个
加尔各答 别名	其他	多个
加尔各答 下辖地区	数字+单位	多个
加尔各答 市长	人名	单个
克雷塔罗 电话区号	数字	单个
克雷塔罗 火车站	百科实体	多个
克雷塔罗 邮政区码	数字	单个
克雷塔罗 政府驻地	其他	单个
克雷塔罗 气候条件	其他	句子
克雷塔罗 面积	数字+单位	单个
克雷塔罗 别名	其他	多个
克雷塔罗 方言	百科实体	单个
克雷塔罗 下辖地区	数字+单位	多个
克雷塔罗 市长	人名	单个
圣多明各 电话区号	数字	单个
圣多明各 著名景点	百科实体	多个
圣多明各 火车站	百科实体	多个
圣多明各 外文名称	其他	单个
圣多明各 邮政区码	数字	单个
圣多明各 政府驻地	其他	单个
圣多明各 地理位置	其他	句子
圣多明各 气候条件	其他	句子
圣多明各 别名	其他	多个
圣多明各 下辖地区	数字+单位	多个
圣多明各 市长	人名	单个
布尔萨 电话区号	数字	单个
布尔萨 火车站	百科实体	多个
布尔萨 邮政区码	数字	单个
布尔萨 政府驻地	其他	单个
布尔萨 面积	数字+单位	单个
布尔萨 别名	其他	多个
布尔萨 机场	百科实体	单个
布尔萨 下辖地区	数字+单位	多个
布尔萨 市长	人名	单个
布拉格 电话区号	数字	单个
布拉格 著名景点	百科实体	多个
布拉格 人口	数字+单位	单个
布拉格 火车站	百科实体	多个
布拉格 外文名称	其他	单个
布拉格 中文名称	其他	单个
布拉格 邮政区码	数字	单个
布拉格 政府驻地	其他	单个
布拉格 行政区类别	其他	单个
布拉格 地理位置	其他	句子
布拉格 气候条件	其他	句子
布拉格 所属地区	其他	单个
布拉格 面积	数字+单位	单个
布拉格 别名	其他	多个
布拉格 机场	百科实体	单个
布拉格 方言	百科实体	单个
布拉格 下辖地区	数字+单位	多个
布拉格 市长	人名	单个
曼海姆 电话区号	数字	单个
曼海姆 火车站	百科实体	多个
曼海姆 行政区类别	其他	单个
曼海姆 气候条件	其他	句子
曼海姆 别名	其他	多个
曼海姆 机场	百科实体	单个
曼海姆 下辖地区	数字+单位	多个
曼海姆 市长	人名	单个
阿德莱德 电话区号	数字	单个
阿德莱德 火车站	百科实体	多个
阿德莱德 邮政区码	数字	单个
阿德莱德 政府驻地	其他	单个
阿德莱德 下辖地区	数字+单位	多个
阿德莱德 市长	人名	单个
莱切斯特 邮政区码	数字	单个
莱切斯特 市长	人名	单个
喀布尔 电话区号	数字	单个
喀布尔 火车站	百科实体	多个
喀布尔 邮政区码	数字	单个
喀布尔 别名	其他	多个
喀布尔 机场	百科实体	单个
喀布尔 市长	人名	单个
塔尔萨 著名景点	百科实体	多个
塔尔萨 火车站	百科实体	多个
塔尔萨 邮政区码	数字	单个
塔尔萨 市长	人名	单个
基辅 火车站	百科实体	多个
基辅 政府驻地	其他	单个
波兹南 电话区号	数字	单个
波兹南 著名景点	百科实体	多个
波兹南 火车站	百科实体	多个
波兹南 外文名称	其他	单个
波兹南 中文名称	其他	单个
波兹南 邮政区码	数字	单个
波兹南 政府驻地	其他	单个
波兹南 行政区类别	其他	单个
波兹南 地理位置	其他	句子
波兹南 气候条件	其他	句子
波兹南 所属地区	其他	单个
波兹南 别名	其他	多个
波兹南 机场	百科实体	单个
波兹南 方言	百科实体	单个
波兹南 下辖地区	数字+单位	多个
波兹南 市长	人名	单个
斯图加特 电话区号	数字	单个
斯图加特 火车站	百科实体	多个
斯图加特 邮政区码	数字	单个
斯图加特 政府驻地	其他	单个
斯图加特 气候条件	其他	句子
斯图加特 别名	其他	多个
斯图加特 下辖地区	数字+单位	多个
斯图加特 市长	人名	单个
盐湖城 电话区号	数字	单个
盐湖城 火车站	百科实体	多个
盐湖城 邮政区码	数字	单个
盐湖城 行政区类别	其他	单个
盐湖城 市长	人名	单个
新奥尔良 火车站	百科实体	多个
新奥尔良 邮政区码	数字	单个
新奥尔良 政府驻地	其他	单个
新奥尔良 别名	其他	多个
新奥尔良 下辖地区	数字+单位	多个
莱比锡 电话区号	数字	单个
莱比锡 著名景点	百科实体	多个
莱比锡 火车站	百科实体	多个
莱比锡 邮政区码	数字	单个
莱比锡 政府驻地	其他	单个
莱比锡 地理位置	其他	句子
莱比锡 气候条件	其他	句子
莱比锡 机场	百科实体	单个
莱比锡 方言	百科实体	单个
莱比锡 下辖地区	数字+单位	多个
莱比锡 市长	人名	单个
摩苏尔 电话区号	数字	单个
摩苏尔 火车站	百科实体	多个
摩苏尔 邮政区码	数字	单个
摩苏尔 政府驻地	其他	单个
摩苏尔 面积	数字+单位	单个
摩苏尔 方言	百科实体	单个
摩苏尔 下辖地区	数字+单位	多个
摩苏尔 市长	人名	单个
班加罗尔 电话区号	数字	单个
班加罗尔 著名景点	百科实体	多个
班加罗尔 火车站	百科实体	多个
班加罗尔 邮政区码	数字	单个
班加罗尔 政府驻地	其他	单个
班加罗尔 行政区类别	其他	单个
班加罗尔 地理位置	其他	句子
班加罗尔 气候条件	其他	句子
班加罗尔 面积	数字+单位	单个
班加罗尔 别名	其他	多个
班加罗尔 机场	百科实体	单个
班加罗尔 方言	百科实体	单个
班加罗尔 下辖地区	数字+单位	多个
班加罗尔 市长	人名	单个
开普敦 电话区号	数字	单个
开普敦 火车站	百科实体	多个
开普敦 邮政区码	数字	单个
开普敦 政府驻地	其他	单个
开普敦 面积	数字+单位	单个
开普敦 下辖地区	数字+单位	多个
温得和克 电话区号	数字	单个
温得和克 著名景点	百科实体	多个
温得和克 外文名称	其他	单个
温得和克 中文名称	其他	单个
温得和克 邮政区码	数字	单个
温得和克 政府驻地	其他	单个
温得和克 行政区类别	其他	单个
温得和克 气候条件	其他	句子
温得和克 别名	其他	多个
温得和克 方言	百科实体	单个
温得和克 下辖地区	数字+单位	多个
新山 电话区号	数字	单个
新山 邮政区码	数字	单个
新山 政府驻地	其他	单个
新山 机场	百科实体	单个
新山 下辖地区	数字+单位	多个
新山 市长	人名	单个
堪培拉 政府驻地	其他	单个
堪培拉 下辖地区	数字+单位	多个
堪培拉 市长	人名	单个
利伯维尔 电话区号	数字	单个
利伯维尔 著名景点	百科实体	多个
利伯维尔 火车站	百科实体	多个
利伯维尔 邮政区码	数字	单个
利伯维尔 政府驻地	其他	单个
利伯维尔 面积	数字+单位	单个
利伯维尔 别名	其他	多个
利伯维尔 方言	百科实体	单个
利伯维尔 下辖地区	数字+单位	多个
利伯维尔 市长	人名	单个
汉密尔顿 下辖地区	数字+单位	多个
汉密尔顿 市长	人名	单个
弗罗茨瓦夫 著名景点	百科实体	多个
弗罗茨瓦夫 火车站	百科实体	多个
弗罗茨瓦夫 政府驻地	其他	单个
弗罗茨瓦夫 机场	百科实体	单个
弗罗茨瓦夫 下辖地区	数字+单位	多个
弗罗茨瓦夫 市长	人名	单个
科隆 电话区号	数字	单个
科隆 邮政区码	数字	单个
科隆 政府驻地	其他	单个
科隆 地理位置	其他	句子
科隆 气候条件	其他	句子
科隆 别名	其他	多个
科隆 机场	百科实体	单个
科隆 下辖地区	数字+单位	多个
科隆 市长	人名	单个
蒂华纳 电话区号	数字	单个
蒂华纳 火车站	百科实体	多个
蒂华纳 邮政区码	数字	单个
蒂华纳 政府驻地	其他	单个
蒂华纳 别名	其他	多个
蒂华纳 机场	百科实体	单个
蒂华纳 下辖地区	数字+单位	多个
蒂华纳 市长	人名	单个
纽伦堡 火车站	百科实体	多个
纽伦堡 政府驻地	其他	单个
纽伦堡 方言	百科实体	单个
纽伦堡 下辖地区	数字+单位	多个
纽伦堡 市长	人名	单个
悉尼 邮政区码	数字	单个
悉尼 政府驻地	其他	单个
悉尼 下辖地区	数字+单位	多个
悉尼 市长	人名	单个
吉达 电话区号	数字	单个
吉达 著名景点	百科实体	多个
吉达 火车站	百科实体	多个
吉达 邮政区码	数字	单个
吉达 政府驻地	其他	单个
吉达 气候条件	其他	句子
吉达 所属地区	其他	单个
吉达 面积	数字+单位	单个
吉达 别名	其他	多个
吉达 机场	百科实体	单个
吉达 下辖地区	数字+单位	多个
吉达 市长	人名	单个
卡利 电话区号	数字	单个
卡利 著名景点	百科实体	多个
卡利 火车站	百科实体	多个
卡利 邮政区码	数字	单个
卡利 政府驻地	其他	单个
卡利 地理位置	其他	句子
卡利 别名	其他	多个
卡利 下辖地区	数字+单位	多个
卡利 市长	人名	单个
内罗毕 火车站	百科实体	多个
内罗毕 邮政区码	数字	单个
内罗毕 政府驻地	其他	单个
内罗毕 别名	其他	多个
内罗毕 下辖地区	数字+单位	多个
内罗毕 市长	人名	单个
雅加达 邮政区码	数字	单个
雅加达 政府驻地	其他	单个
雅加达 市长	人名	单个
麦迪逊 电话区号	数字	单个
麦迪逊 著名景点	百科实体	多个
麦迪逊 人口	数字+单位	单个
麦迪逊 火车站	百科实体	多个
麦迪逊 外文名称	其他	单个
麦迪逊 中文名称	其他	单个
麦迪逊 邮政区码	数字	单个
麦迪逊 政府驻地	其他	单个
麦迪逊 行政区类别	其他	单个
麦迪逊 地理位置	其他	句子
麦迪逊 气候条件	其他	句子
麦迪逊 所属地区	其他	单个
麦迪逊 面积	数字+单位	单个
麦迪逊 别名	其他	多个
麦迪逊 机场	百科实体	单个
麦迪逊 方言	百科实体	单个
麦迪逊 下辖地区	数字+单位	多个
麦迪逊 市长	人名	单个
多哈 火车站	百科实体	多个
多哈 政府驻地	其他	单个
多哈 别名	其他	多个
多哈 下辖地区	数字+单位	多个
多哈 市长	人名	单个
拉合尔 火车站	百科实体	多个
拉合尔 邮政区码	数字	单个
拉合尔 政府驻地	其他	单个
拉合尔 面积	数字+单位	单个
拉合尔 下辖地区	数字+单位	多个
拉合尔 市长	人名	单个
布里斯班 电话区号	数字	单个
布里斯班 邮政区码	数字	单个
布里斯班 政府驻地	其他	单个
布里斯班 别名	其他	多个
布里斯班 下辖地区	数字+单位	多个
布里斯班 市长	人名	单个
哈利法克斯 市长	人名	单个
达曼 电话区号	数字	单个
达曼 著名景点	百科实体	多个
达曼 人口	数字+单位	单个
达曼 火车站	百科实体	多个
达曼 外文名称	其他	单个
达曼 邮政区码	数字	单个
达曼 政府驻地	其他	单个
达曼 地理位置	其他	句子
达曼 气候条件	其他	句子
达曼 面积	数字+单位	单个
达曼 别名	其他	多个
达曼 机场	百科实体	单个
达曼 下辖地区	数字+单位	多个
达曼 市长	人名	单个
阿雷格里港 火车站	百科实体	多个
阿雷格里港 邮政区码	数字	单个
阿雷格里港 政府驻地	其他	单个
阿雷格里港 下辖地区	数字+单位	多个
阿雷格里港 市长	人名	单个
比勒陀利亚 著名景点	百科实体	多个
比勒陀利亚 火车站	百科实体	多个
比勒陀利亚 邮政区码	数字	单个
比勒陀利亚 政府驻地	其他	单个
比勒陀利亚 所属地区	其他	单个
比勒陀利亚 方言	百科实体	单个
比勒陀利亚 下辖地区	数字+单位	多个
比勒陀利亚 市长	人名	单个
卑尔根 电话区号	数字	单个
卑尔根 火车站	百科实体	多个
卑尔根 邮政区码	数字	单个
卑尔根 政府驻地	其他	单个
卑尔根 气候条件	其他	句子
卑尔根 市长	人名	单个
波士顿 政府驻地	其他	单个
波士顿 方言	百科实体	单个
名古屋 市长	人名	单个
惠灵顿 政府驻地	其他	单个
惠灵顿 下辖地区	数字+单位	多个
惠灵顿 市长	人名	单个
特古西加尔巴 火车站	百科实体	多个
特古西加尔巴 邮政区码	数字	单个
特古西加尔巴 政府驻地	其他	单个
特古西加尔巴 行政区类别	其他	单个
特古西加尔巴 气候条件	其他	句子
特古西加尔巴 方言	百科实体	单个
特古西加尔巴 下辖地区	数字+单位	多个
特古西加尔巴 市长	人名	单个
奥克兰 火车站	百科实体	多个
奥克兰 邮政区码	数字	单个
奥克兰 政府驻地	其他	单个
奥克兰 下辖地区	数字+单位	多个
奥克兰 市长	人名	单个
达喀尔 火车站	百科实体	多个
达喀尔 政府驻地	其他	单个
达喀尔 别名	其他	多个
达喀尔 下辖地区	数字+单位	多个
达喀尔 市长	人名	单个
不莱梅 电话区号	数字	单个
不莱梅 著名景点	百科实体	多个
不莱梅 人口	数字+单位	单个
不莱梅 火车站	百科实体	多个
不莱梅 外文名称	其他	单个
不莱梅 中文名称	其他	单个
不莱梅 邮政区码	数字	单个
不莱梅 政府驻地	其他	单个
不莱梅 行政区类别	其他	单个
不莱梅 地理位置	其他	句子
不莱梅 气候条件	其他	句子
不莱梅 面积	数字+单位	单个
不莱梅 别名	其他	多个
不莱梅 机场	百科实体	单个
不莱梅 方言	百科实体	单个
不莱梅 下辖地区	数字+单位	多个
不莱梅 市长	人名	单个
汉堡 别名	其他	多个
底特律 政府驻地	其他	单个
汉诺威 电话区号	数字	单个
汉诺威 火车站	百科实体	多个
汉诺威 邮政区码	数字	单个
汉诺威 政府驻地	其他	单个
汉诺威 所属地区	其他	单个
汉诺威 别名	其他	多个
汉诺威 机场	百科实体	单个
汉诺威 下辖地区	数字+单位	多个
汉诺威 市长	人名	单个
尼斯 下辖地区	数字+单位	多个
尼斯 市长	人名	单个
科钦 电话区号	数字	单个
科钦 著名景点	百科实体	多个
科钦 人口	数字+单位	单个
科钦 火车站	百科实体	多个
科钦 外文名称	其他	单个
科钦 中文名称	其他	单个
科钦 邮政区码	数字	单个
科钦 政府驻地	其他	单个
科钦 行政区类别	其他	单个
科钦 地理位置	其他	句子
科钦 气候条件	其他	句子
科钦 所属地区	其他	单个
科钦 面积	数字+单位	单个
科钦 别名	其他	多个
科钦 机场	百科实体	单个
科钦 方言	百科实体	单个
科钦 下辖地区	数字+单位	多个
科钦 市长	人名	单个
孟买 电话区号	数字	单个
孟买 邮政区码	数字	单个
孟买 政府驻地	其他	单个
孟买 别名	其他	多个
孟买 市长	人名	单个
孟菲斯 电话区号	数字	单个
孟菲斯 邮政区码	数字	单个
孟菲斯 政府驻地	其他	单个
孟菲斯 下辖地区	数字+单位	多个
马尔默 电话区号	数字	单个
马尔默 火车站	百科实体	多个
马尔默 邮政区码	数字	单个
马尔默 政府驻地	其他	单个
马尔默 地理位置	其他	句子
马尔默 面积	数字+单位	单个
马尔默 机场	百科实体	单个
马尔默 方言	百科实体	单个
马尔默 下辖地区	数字+单位	多个
马尔默 市长	人名	单个
高雄 市长	人名	单个
坎皮纳斯 著名景点	百科实体	多个
坎皮纳斯 火车站	百科实体	多个
坎皮纳斯 政府驻地	其他	单个
坎皮纳斯 地理位置	其他	句子
坎皮纳斯 气候条件	其他	句子
坎皮纳斯 别名	其他	多个
坎皮纳斯 方言	百科实体	单个
坎皮纳斯 下辖地区	数字+单位	多个
坎皮纳斯 市长	人名	单个
巴塞尔 著名景点	百科实体	多个
巴塞尔 火车站	百科实体	多个
巴塞尔 政府驻地	其他	单个
巴塞尔 地理位置	其他	句子
巴塞尔 别名	其他	多个
巴塞尔 机场	百科实体	单个
巴塞尔 下辖地区	数字+单位	多个
巴塞尔 市长	人名	单个
迈阿密 火车站	百科实体	多个
迈阿密 邮政区码	数字	单个
迈阿密 政府驻地	其他	单个
迈阿密 下辖地区	数字+单位	多个
迈阿密 市长	人名	单个
华沙 政府驻地	其他	单个
华沙 下辖地区	数字+单位	多个
华沙 市长	人名	单个
格拉斯哥 电话区号	数字	单个
格拉斯哥 火车站	百科实体	多个
格拉斯哥 邮政区码	数字	单个
格拉斯哥 政府驻地	其他	单个
格拉斯哥 地理位置	其他	句子
格拉斯哥 气候条件	其他	句子
格拉斯哥 别名	其他	多个
格拉斯哥 下辖地区	数字+单位	多个
格拉斯哥 市长	人名	单个
罗安达 电话区号	数字	单个
罗安达 著名景点	百科实体	多个
罗安达 火车站	百科实体	多个
罗安达 外文名称	其他	单个
罗安达 中文名称	其他	单个
罗安达 邮政区码	数字	单个
罗安达 政府驻地	其他	单个
罗安达 行政区类别	其他	单个
罗安达 地理位置	其他	句子
罗安达 气候条件	其他	句子
罗安达 所属地区	其他	单个
罗安达 别名	其他	多个
罗安达 机场	百科实体	单个
罗安达 方言	百科实体	单个
罗安达 下辖地区	数字+单位	多个
罗安达 市长	人名	单个
埃德蒙顿 火车站	百科实体	多个
埃德蒙顿 邮政区码	数字	单个
埃德蒙顿 下辖地区	数字+单位	多个
路易斯维尔 电话区号	数字	单个
路易斯维尔 火车站	百科实体	多个
路易斯维尔 邮政区码	数字	单个
路易斯维尔 政府驻地	其他	单个
路易斯维尔 行政区类别	其他	单个
路易斯维尔 气候条件	其他	句子
路易斯维尔 所属地区	其他	单个
路易斯维尔 别名	其他	多个
路易斯维尔 机场	百科实体	单个
路易斯维尔 下辖地区	数字+单位	多个
路易斯维尔 市长	人名	单个
伊斯坦布尔 政府驻地	其他	单个
伊斯坦布尔 行政区类别	其他	单个
伊斯坦布尔 下辖地区	数字+单位	多个
伦敦 邮政区码	数字	单个
阿拉木图 著名景点	百科实体	多个
阿拉木图 政府驻地	其他	单个
阿拉木图 市长	人名	单个
阿伯丁 著名景点	百科实体	多个
阿伯丁 人口	数字+单位	单个
阿伯丁 火车站	百科实体	多个
阿伯丁 政府驻地	其他	单个
阿伯丁 气候条件	其他	句子
阿伯丁 面积	数字+单位	单个
阿伯丁 别名	其他	多个
阿伯丁 机场	百科实体	单个
阿伯丁 方言	百科实体	单个
阿伯丁 下辖地区	数字+单位	多个
阿伯丁 市长	人名	单个
罗兹 电话区号	数字	单个
罗兹 著名景点	百科实体	多个
罗兹 人口	数字+单位	单个
罗兹 火车站	百科实体	多个
罗兹 外文名称	其他	单个
罗兹 中文名称	其他	单个
罗兹 邮政区码	数字	单个
罗兹 政府驻地	其他	单个
罗兹 行政区类别	其他	单个
罗兹 地理位置	其他	句子
罗兹 气候条件	其他	句子
罗兹 所属地区	其他	单个
罗兹 面积	数字+单位	单个
罗兹 别名	其他	多个
罗兹 机场	百科实体	单个
罗兹 方言	百科实体	单个
罗兹 下辖地区	数字+单位	多个
罗兹 市长	人名	单个
拉斯维加斯 火车站	百科实体	多个
拉斯维加斯 邮政区码	数字	单个
拉斯维加斯 政府驻地	其他	单个
巴库 火车站	百科实体	多个
巴库 政府驻地	其他	单个
巴库 气候条件	其他	句子
巴库 别名	其他	多个
巴库 方言	百科实体	单个
巴库 下辖地区	数字+单位	多个
宿雾 电话区号	数字	单个
宿雾 著名景点	百科实体	多个
宿雾 人口	数字+单位	单个
宿雾 火车站	百科实体	多个
宿雾 外文名称	其他	单个
宿雾 中文名称	其他	单个
宿雾 邮政区码	数字	单个
宿雾 政府驻地	其他	单个
宿雾 行政区类别	其他	单个
宿雾 地理位置	其他	句子
宿雾 气候条件	其他	句子
宿雾 所属地区	其他	单个
宿雾 面积	数字+单位	单个
宿雾 别名	其他	多个
宿雾 机场	百科实体	单个
宿雾 方言	百科实体	单个
宿雾 下辖地区	数字+单位	多个
宿雾 市长	人名	单个
德雷斯顿 电话区号	数字	单个
德雷斯顿 火车站	百科实体	多个
德雷斯顿 邮政区码	数字	单个
德雷斯顿 政府驻地	其他	单个
德雷斯顿 行政区类别	其他	单个
德雷斯顿 气候条件	其他	句子
德雷斯顿 别名	其他	多个
德雷斯顿 机场	百科实体	单个
德雷斯顿 方言	百科实体	单个
德雷斯顿 下辖地区	数字+单位	多个
德雷斯顿 市长	人名	单个
尼科西亚 电话区号	数字	单个
尼科西亚 人口	数字+单位	单个
尼科西亚 火车站	百科实体	多个
尼科西亚 邮政区码	数字	单个
尼科西亚 政府驻地	其他	单个
尼科西亚 气候条件	其他	句子
尼科西亚 别名	其他	多个
尼科西亚 机场	百科实体	单个
尼科西亚 下辖地区	数字+单位	多个
尼科西亚 市长	人名	单个
博洛尼亚 电话区号	数字	单个
博洛尼亚 邮政区码	数字	单个
博洛尼亚 政府驻地	其他	单个
博洛尼亚 气候条件	其他	句子
博洛尼亚 方言	百科实体	单个
博洛尼亚 下辖地区	数字+单位	多个
博洛尼亚 市长	人名	单个
巴尔的摩 电话区号	数字	单个
巴尔的摩 著名景点	百科实体	多个
巴尔的摩 邮政区码	数字	单个
巴尔的摩 政府驻地	其他	单个
巴尔的摩 下辖地区	数字+单位	多个
巴尔的摩 市长	人名	单个
金斯敦 电话区号	数字	单个
金斯敦 著名景点	百科实体	多个
金斯敦 火车站	百科实体	多个
金斯敦 邮政区码	数字	单个
金斯敦 政府驻地	其他	单个
金斯敦 别名	其他	多个
金斯敦 下辖地区	数字+单位	多个
墨尔本 火车站	百科实体	多个
墨尔本 邮政区码	数字	单个
墨尔本 下辖地区	数字+单位	多个
墨尔本 市长	人名	单个
麦纳麦 电话区号	数字	单个
麦纳麦 火车站	百科实体	多个
麦纳麦 外文名称	其他	单个
麦纳麦 邮政区码	数字	单个
麦纳麦 政府驻地	其他	单个
麦纳麦 下辖地区	数字+单位	多个
麦纳麦 市长	人名	单个
奇瓦瓦 电话区号	数字	单个
奇瓦瓦 火车站	百科实体	多个
奇瓦瓦 邮政区码	数字	单个
奇瓦瓦 气候条件	其他	句子
奇瓦瓦 别名	其他	多个
奇瓦瓦 机场	百科实体	单个
奇瓦瓦 方言	百科实体	单个
奇瓦瓦 下辖地区	数字+单位	多个
奇瓦瓦 市长	人名	单个
德班 火车站	百科实体	多个
德班 邮政区码	数字	单个
德班 政府驻地	其他	单个
德班 别名	其他	多个
德班 下辖地区	数字+单位	多个
德班 市长	人名	单个
基督城 火车站	百科实体	多个
基督城 邮政区码	数字	单个
基督城 下辖地区	数字+单位	多个
多特蒙德 电话区号	数字	单个
多特蒙德 著名景点	百科实体	多个
多特蒙德 人口	数字+单位	单个
多特蒙德 火车站	百科实体	多个
多特蒙德 外文名称	其他	单个
多特蒙德 中文名称	其他	单个
多特蒙德 邮政区码	数字	单个
多特蒙德 政府驻地	其他	单个
多特蒙德 行政区类别	其他	单个
多特蒙德 地理位置	其他	句子
多特蒙德 气候条件	其他	句子
多特蒙德 面积	数字+单位	单个
多特蒙德 别名	其他	多个
多特蒙德 机场	百科实体	单个
多特蒙德 方言	百科实体	单个
多特蒙德 下辖地区	数字+单位	多个
多特蒙德 市长	人名	单个
伯尔尼 下辖地区	数字+单位	多个
伯尔尼 市长	人名	单个
瓦尔帕莱索 电话区号	数字	单个
瓦尔帕莱索 邮政区码	数字	单个
瓦尔帕莱索 政府驻地	其他	单个
南安普顿 电话区号	数字	单个
南安普顿 著名景点	百科实体	多个
南安普顿 人口	数字+单位	单个
南安普顿 火车站	百科实体	多个
南安普顿 外文名称	其他	单个
南安普顿 中文名称	其他	单个
南安普顿 邮政区码	数字	单个
南安普顿 政府驻地	其他	单个
南安普顿 行政区类别	其他	单个
南安普顿 地理位置	其他	句子
南安普顿 气候条件	其他	句子
南安普顿 面积	数字+单位	单个
南安普顿 别名	其他	多个
南安普顿 机场	百科实体	单个
南安普顿 方言	百科实体	单个
南安普顿 下辖地区	数字+单位	多个
南安普顿 市长	人名	单个
萨拉热窝 电话区号	数字	单个
萨拉热窝 火车站	百科实体	多个
萨拉热窝 邮政区码	数字	单个
萨拉热窝 政府驻地	其他	单个
萨拉热窝 方言	百科实体	单个
萨拉热窝 市长	人名	单个
安特卫普 电话区号	数字	单个
安特卫普 著名景点	百科实体	多个
安特卫普 火车站	百科实体	多个
安特卫普 邮政区码	数字	单个
安特卫普 政府驻地	其他	单个
安特卫普 行政区类别	其他	单个
安特卫普 气候条件	其他	句子
安特卫普 所属地区	其他	单个
安特卫普 别名	其他	多个
安特卫普 机场	百科实体	单个
安特卫普 下辖地区	数字+单位	多个
安特卫普 市长	人名	单个
格拉茨 电话区号	数字	单个
格拉茨 著名景点	百科实体	多个
格拉茨 火车站	百科实体	多个
格拉茨 邮政区码	数字	单个
格拉茨 政府驻地	其他	单个
格拉茨 行政区类别	其他	单个
格拉茨 地理位置	其他	句子
格拉茨 气候条件	其他	句子
格拉茨 别名	其他	多个
格拉茨 机场	百科实体	单个
格拉茨 方言	百科实体	单个
格拉茨 市长	人名	单个
新德里 火车站	百科实体	多个
新德里 政府驻地	其他	单个
新德里 气候条件	其他	句子
新德里 别名	其他	多个
新德里 下辖地区	数字+单位	多个
新德里 市长	人名	单个
维尔纽斯 电话区号	数字	单个
维尔纽斯 邮政区码	数字	单个
维尔纽斯 政府驻地	其他	单个
维尔纽斯 别名	其他	多个
维尔纽斯 方言	百科实体	单个
维尔纽斯 下辖地区	数字+单位	多个
梅里达 电话区号	数字	单个
梅里达 著名景点	百科实体	多个
梅里达 火车站	百科实体	多个
梅里达 邮政区码	数字	单个
梅里达 政府驻地	其他	单个
梅里达 气候条件	其他	句子
梅里达 面积	数字+单位	单个
梅里达 别名	其他	多个
梅里达 机场	百科实体	单个
梅里达 方言	百科实体	单个
梅里达 下辖地区	数字+单位	多个
梅里达 市长	人名	单个
日内瓦 电话区号	数字	单个
日内瓦 邮政区码	数字	单个
日内瓦 政府驻地	其他	单个
日内瓦 别名	其他	多个
日内瓦 方言	百科实体	单个
日内瓦 下辖地区	数字+单位	多个
日内瓦 市长	人名	单个
戈亚尼亚 著名景点	百科实体	多个
戈亚尼亚 火车站	百科实体	多个
戈亚尼亚 邮政区码	数字	单个
戈亚尼亚 政府驻地	其他	单个
戈亚尼亚 气候条件	其他	句子
戈亚尼亚 别名	其他	多个
戈亚尼亚 机场	百科实体	单个
戈亚尼亚 下辖地区	数字+单位	多个
戈亚尼亚 市长	人名	单个
的黎波里 邮政区码	数字	单个
的黎波里 政府驻地	其他	单个
的黎波里 市长	人名	单个
帕罗奥图 电话区号	数字	单个
帕罗奥图 著名景点	百科实体	多个
帕罗奥图 人口	数字+单位	单个
帕罗奥图 火车站	百科实体	多个
帕罗奥图 外文名称	其他	单个
帕罗奥图 中文名称	其他	单个
帕罗奥图 邮政区码	数字	单个
帕罗奥图 政府驻地	其他	单个
帕罗奥图 行政区类别	其他	单个
帕罗奥图 地理位置	其他	句子
帕罗奥图 气候条件	其他	句子
帕罗奥图 所属地区	其他	单个
帕罗奥图 面积	数字+单位	单个
帕罗奥图 别名	其他	多个
帕罗奥图 机场	百科实体	单个
帕罗奥图 方言	百科实体	单个
帕罗奥图 下辖地区	数字+单位	多个
帕罗奥图 市长	人名	单个
马尼拉 火车站	百科实体	多个
圣克鲁斯 电话区号	数字	单个
圣克鲁斯 著名景点	百科实体	多个
圣克鲁斯 人口	数字+单位	单个
圣克鲁斯 火车站	百科实体	多个
圣克鲁斯 外文名称	其他	单个
圣克鲁斯 中文名称	其他	单个
圣克鲁斯 邮政区码	数字	单个
圣克鲁斯 政府驻地	其他	单个
圣克鲁斯 行政区类别	其他	单个
圣克鲁斯 地理位置	其他	句子
圣克鲁斯 气候条件	其他	句子
圣克鲁斯 所属地区	其他	单个
圣克鲁斯 面积	数字+单位	单个
圣克鲁斯 别名	其他	多个
圣克鲁斯 机场	百科实体	单个
圣克鲁斯 方言	百科实体	单个
圣克鲁斯 下辖地区	数字+单位	多个
圣克鲁斯 市长	人名	单个
波德戈里察 下辖地区	数字+单位	多个
卡托维兹 电话区号	数字	单个
卡托维兹 著名景点	百科实体	多个
卡托维兹 火车站	百科实体	多个
卡托维兹 邮政区码	数字	单个
卡托维兹 政府驻地	其他	单个
卡托维兹 行政区类别	其他	单个
卡托维兹 地理位置	其他	句子
卡托维兹 气候条件	其他	句子
卡托维兹 所属地区	其他	单个
卡托维兹 面积	数字+单位	单个
卡托维兹 机场	百科实体	单个
卡托维兹 方言	百科实体	单个
卡托维兹 下辖地区	数字+单位	多个
卡托维兹 市长	人名	单个
河内 政府驻地	其他	单个
河内 市长	人名	单个
胡志明市 市长	人名	单个
雅典 政府驻地	其他	单个
布加勒斯特 电话区号	数字	单个
布加勒斯特 火车站	百科实体	多个
布加勒斯特 邮政区码	数字	单个
布加勒斯特 政府驻地	其他	单个
布加勒斯特 所属地区	其他	单个
布加勒斯特 下辖地区	数字+单位	多个
布加勒斯特 市长	人名	单个
利物浦 电话区号	数字	单个
利物浦 著名景点	百科实体	多个
利物浦 人口	数字+单位	单个
利物浦 火车站	百科实体	多个
利物浦 外文名称	其他	单个
利物浦 中文名称	其他	单个
利物浦 邮政区码	数字	单个
利物浦 政府驻地	其他	单个
利物浦 行政区类别	其他	单个
利物浦 地理位置	其他	句子
利物浦 气候条件	其他	句子
利物浦 面积	数字+单位	单个
利物浦 别名	其他	多个
利物浦 机场	百科实体	单个
利物浦 方言	百科实体	单个
利物浦 下辖地区	数字+单位	多个
利物浦 市长	人名	单个
马普托 电话区号	数字	单个
马普托 著名景点	百科实体	多个
马普托 外文名称	其他	单个
马普托 邮政区码	数字	单个
马普托 政府驻地	其他	单个
马普托 气候条件	其他	句子
马普托 别名	其他	多个
马普托 方言	百科实体	单个
马普托 下辖地区	数字+单位	多个
马普托 市长	人名	单个
圣迭戈 火车站	百科实体	多个
圣迭戈 政府驻地	其他	单个
马斯喀特 电话区号	数字	单个
马斯喀特 火车站	百科实体	多个
马斯喀特 政府驻地	其他	单个
马斯喀特 别名	其他	多个
马斯喀特 市长	人名	单个
都柏林 电话区号	数字	单个
都柏林 邮政区码	数字	单个
都柏林 政府驻地	其他	单个
都柏林 地理位置	其他	句子
都柏林 下辖地区	数字+单位	多个
都柏林 市长	人名	单个
瓜亚基尔 电话区号	数字	单个
瓜亚基尔 火车站	百科实体	多个
瓜亚基尔 邮政区码	数字	单个
瓜亚基尔 政府驻地	其他	单个
瓜亚基尔 别名	其他	多个
瓜亚基尔 下辖地区	数字+单位	多个
瓜亚基尔 市长	人名	单个
贝洛奥里藏特 电话区号	数字	单个
贝洛奥里藏特 著名景点	百科实体	多个
贝洛奥里藏特 人口	数字+单位	单个
贝洛奥里藏特 火车站	百科实体	多个
贝洛奥里藏特 外文名称	其他	单个
贝洛奥里藏特 邮政区码	数字	单个
贝洛奥里藏特 政府驻地	其他	单个
贝洛奥里藏特 行政区类别	其他	单个
贝洛奥里藏特 机场	百科实体	单个
贝洛奥里藏特 方言	百科实体	单个
贝洛奥里藏特 下辖地区	数字+单位	多个
贝洛奥里藏特 市长	人名	单个
杜阿拉 电话区号	数字	单个
杜阿拉 著名景点	百科实体	多个
杜阿拉 火车站	百科实体	多个
杜阿拉 邮政区码	数字	单个
杜阿拉 政府驻地	其他	单个
杜阿拉 方言	百科实体	单个
杜阿拉 下辖地区	数字+单位	多个
杜阿拉 市长	人名	单个
第比利斯 电话区号	数字	单个
第比利斯 邮政区码	数字	单个
第比利斯 政府驻地	其他	单个
第比利斯 别名	其他	多个
第比利斯 下辖地区	数字+单位	多个
米兰 电话区号	数字	单个
米兰 政府驻地	其他	单个
米兰 市长	人名	单个
慕尼黑 政府驻地	其他	单个
夏洛特 电话区号	数字	单个
夏洛特 著名景点	百科实体	多个
夏洛特 人口	数字+单位	单个
夏洛特 火车站	百科实体	多个
夏洛特 外文名称	其他	单个
夏洛特 中文名称	其他	单个
夏洛特 邮政区码	数字	单个
夏洛特 政府驻地	其他	单个
夏洛特 行政区类别	其他	单个
夏洛特 地理位置	其他	句子
夏洛特 气候条件	其他	句子
夏洛特 所属地区	其他	单个
夏洛特 面积	数字+单位	单个
夏洛特 别名	其他	多个
夏洛特 机场	百科实体	单个
夏洛特 方言	百科实体	单个
夏洛特 下辖地区	数字+单位	多个
夏洛特 市长	人名	单个
伊丽莎白港 电话区号	数字	单个
伊丽莎白港 著名景点	百科实体	多个
伊丽莎白港 人口	数字+单位	单个
伊丽莎白港 火车站	百科实体	多个
伊丽莎白港 外文名称	其他	单个
伊丽莎白港 邮政区码	数字	单个
伊丽莎白港 政府驻地	其他	单个
伊丽莎白港 行政区类别	其他	单个
伊丽莎白港 气候条件	其他	句子
伊丽莎白港 面积	数字+单位	单个
伊丽莎白港 别名	其他	多个
伊丽莎白港 机场	百科实体	单个
伊丽莎白港 方言	百科实体	单个
伊丽莎白港 下辖地区	数字+单位	多个
伊丽莎白港 市长	人名	单个
哈拉雷 电话区号	数字	单个
哈拉雷 著名景点	百科实体	多个
哈拉雷 火车站	百科实体	多个
哈拉雷 邮政区码	数字	单个
哈拉雷 政府驻地	其他	单个
哈拉雷 气候条件	其他	句子
哈拉雷 机场	百科实体	单个
哈拉雷 方言	百科实体	单个
哈拉雷 下辖地区	数字+单位	多个
哈拉雷 市长	人名	单个
圣何塞 电话区号	数字	单个
圣何塞 下辖地区	数字+单位	多个
圣何塞 市长	人名	单个
休斯敦 著名景点	百科实体	多个
休斯敦 火车站	百科实体	多个
休斯敦 地理位置	其他	句子
休斯敦 方言	百科实体	单个
休斯敦 下辖地区	数字+单位	多个
休斯敦 市长	人名	单个
科伦坡 电话区号	数字	单个
科伦坡 著名景点	百科实体	多个
科伦坡 火车站	百科实体	多个
科伦坡 外文名称	其他	单个
科伦坡 中文名称	其他	单个
科伦坡 邮政区码	数字	单个
科伦坡 政府驻地	其他	单个
科伦坡 行政区类别	其他	单个
科伦坡 气候条件	其他	句子
科伦坡 所属地区	其他	单个
科伦坡 别名	其他	多个
科伦坡 机场	百科实体	单个
科伦坡 方言	百科实体	单个
科伦坡 下辖地区	数字+单位	多个
科伦坡 市长	人名	单个
阿克拉 火车站	百科实体	多个
阿克拉 邮政区码	数字	单个
阿克拉 政府驻地	其他	单个
阿克拉 方言	百科实体	单个
阿克拉 下辖地区	数字+单位	多个
阿克拉 市长	人名	单个
奥马哈 电话区号	数字	单个
奥马哈 著名景点	百科实体	多个
奥马哈 火车站	百科实体	多个
奥马哈 外文名称	其他	单个
奥马哈 邮政区码	数字	单个
奥马哈 政府驻地	其他	单个
奥马哈 行政区类别	其他	单个
奥马哈 地理位置	其他	句子
奥马哈 气候条件	其他	句子
奥马哈 面积	数字+单位	单个
奥马哈 别名	其他	多个
奥马哈 机场	百科实体	单个
奥马哈 方言	百科实体	单个
奥马哈 下辖地区	数字+单位	多个
奥马哈 市长	人名	单个
坦帕 电话区号	数字	单个
坦帕 著名景点	百科实体	多个
坦帕 火车站	百科实体	多个
坦帕 邮政区码	数字	单个
坦帕 政府驻地	其他	单个
坦帕 下辖地区	数字+单位	多个
克赖斯特彻奇 火车站	百科实体	多个
克赖斯特彻奇 邮政区码	数字	单个
克赖斯特彻奇 下辖地区	数字+单位	多个
利马 电话区号	数字	单个
利马 著名景点	百科实体	多个
利马 人口	数字+单位	单个
利马 火车站	百科实体	多个
利马 外文名称	其他	单个
利马 中文名称	其他	单个
利马 邮政区码	数字	单个
利马 政府驻地	其他	单个
利马 行政区类别	其他	单个
利马 地理位置	其他	句子
利马 气候条件	其他	句子
利马 所属地区	其他	单个
利马 面积	数字+单位	单个
利马 机场	百科实体	单个
利马 方言	百科实体	单个
利马 下辖地区	数字+单位	多个
利马 市长	人名	单个
纽卡斯尔 下辖地区	数字+单位	多个
纽卡斯尔 市长	人名	单个
萨那 电话区号	数字	单个
萨那 火车站	百科实体	多个
萨那 邮政区码	数字	单个
萨那 面积	数字+单位	单个
萨那 别名	其他	多个
萨那 下辖地区	数字+单位	多个
萨那 市长	人名	单个
罗萨里奥 电话区号	数字	单个
罗萨里奥 火车站	百科实体	多个
罗萨里奥 邮政区码	数字	单个
罗萨里奥 政府驻地	其他	单个
罗萨里奥 别名	其他	多个
罗萨里奥 下辖地区	数字+单位	多个
罗萨里奥 市长	人名	单个
安拉阿巴德 电话区号	数字	单个
安拉阿巴德 火车站	百科实体	多个
安拉阿巴德 邮政区码	数字	单个
安拉阿巴德 政府驻地	其他	单个
安拉阿巴德 行政区类别	其他	单个
安拉阿巴德 气候条件	其他	句子
安拉阿巴德 面积	数字+单位	单个
安拉阿巴德 别名	其他	多个
安拉阿巴德 机场	百科实体	单个
安拉阿巴德 方言	百科实体	单个
安拉阿巴德 下辖地区	数字+单位	多个
安拉阿巴德 市长	人名	单个
达卡 著名景点	百科实体	多个
达卡 政府驻地	其他	单个
达卡 机场	百科实体	单个
达卡 下辖地区	数字+单位	多个
达卡 市长	人名	单个
拿骚 火车站	百科实体	多个
拿骚 政府驻地	其他	单个
拿骚 下辖地区	数字+单位	多个
拿骚 市长	人名	单个
旧金山 下辖地区	数字+单位	多个
地拉那 电话区号	数字	单个
地拉那 火车站	百科实体	多个
地拉那 邮政区码	数字	单个
地拉那 政府驻地	其他	单个
地拉那 行政区类别	其他	单个
地拉那 气候条件	其他	句子
地拉那 面积	数字+单位	单个
地拉那 别名	其他	多个
地拉那 机场	百科实体	单个
地拉那 方言	百科实体	单个
地拉那 下辖地区	数字+单位	多个
地拉那 市长	人名	单个
明斯克 电话区号	数字	单个
明斯克 邮政区码	数字	单个
明斯克 政府驻地	其他	单个
明斯克 地理位置	其他	句子
明斯克 别名	其他	多个
明斯克 下辖地区	数字+单位	多个
斯特拉斯堡 下辖地区	数字+单位	多个
斯特拉斯堡 市长	人名	单个
匹兹堡 火车站	百科实体	多个
匹兹堡 下辖地区	数字+单位	多个
金奈 电话区号	数字	单个
金奈 火车站	百科实体	多个
金奈 邮政区码	数字	单个
金奈 行政区类别	其他	单个
金奈 气候条件	其他	句子
金奈 别名	其他	多个
金奈 机场	百科实体	单个
金奈 方言	百科实体	单个
金奈 下辖地区	数字+单位	多个
金奈 市长	人名	单个
西班牙港 电话区号	数字	单个
西班牙港 火车站	百科实体	多个
西班牙港 外文名称	其他	单个
西班牙港 邮政区码	数字	单个
西班牙港 政府驻地	其他	单个
西班牙港 面积	数字+单位	单个
西班牙港 别名	其他	多个
西班牙港 机场	百科实体	单个
西班牙港 下辖地区	数字+单位	多个
西班牙港 市长	人名	单个
爱丁堡 邮政区码	数字	单个
爱丁堡 政府驻地	其他	单个
爱丁堡 气候条件	其他	句子
爱丁堡 下辖地区	数字+单位	多个
爱丁堡 市长	人名	单个
圣安东尼奥 电话区号	数字	单个
圣安东尼奥 著名景点	百科实体	多个
圣安东尼奥 火车站	百科实体	多个
圣安东尼奥 邮政区码	数字	单个
圣安东尼奥 政府驻地	其他	单个
圣安东尼奥 地理位置	其他	句子
圣安东尼奥 别名	其他	多个
圣安东尼奥 方言	百科实体	单个
圣安东尼奥 下辖地区	数字+单位	多个
圣安东尼奥 市长	人名	单个
阿姆斯特丹 下辖地区	数字+单位	多个
圣路易斯 火车站	百科实体	多个
圣路易斯 政府驻地	其他	单个
圣路易斯 下辖地区	数字+单位	多个
华盛顿 电话区号	数字	单个
华盛顿 著名景点	百科实体	多个
华盛顿 人口	数字+单位	单个
华盛顿 火车站	百科实体	多个
华盛顿 外文名称	其他	单个
华盛顿 中文名称	其他	单个
华盛顿 邮政区码	数字	单个
华盛顿 政府驻地	其他	单个
华盛顿 行政区类别	其他	单个
华盛顿 地理位置	其他	句子
华盛顿 气候条件	其他	句子
华盛顿 所属地区	其他	单个
华盛顿 面积	数字+单位	单个
华盛顿 别名	其他	多个
华盛顿 机场	百科实体	单个
华盛顿 方言	百科实体	单个
华盛顿 下辖地区	数字+单位	多个
华盛顿 市长	人名	单个
达累斯萨拉姆 邮政区码	数字	单个
达累斯萨拉姆 政府驻地	其他	单个
达累斯萨拉姆 气候条件	其他	句子
达累斯萨拉姆 下辖地区	数字+单位	多个
辛辛那提 电话区号	数字	单个
辛辛那提 著名景点	百科实体	多个
辛辛那提 火车站	百科实体	多个
辛辛那提 邮政区码	数字	单个
辛辛那提 政府驻地	其他	单个
辛辛那提 行政区类别	其他	单个
辛辛那提 气候条件	其他	句子
辛辛那提 所属地区	其他	单个
辛辛那提 别名	其他	多个
辛辛那提 机场	百科实体	单个
辛辛那提 方言	百科实体	单个
辛辛那提 下辖地区	数字+单位	多个
辛辛那提 市长	人名	单个
塔那那利佛 电话区号	数字	单个
塔那那利佛 著名景点	百科实体	多个
塔那那利佛 火车站	百科实体	多个
塔那那利佛 邮政区码	数字	单个
塔那那利佛 政府驻地	其他	单个
塔那那利佛 行政区类别	其他	单个
塔那那利佛 面积	数字+单位	单个
塔那那利佛 别名	其他	多个
塔那那利佛 下辖地区	数字+单位	多个
塔那那利佛 市长	人名	单个
萨尔瓦多 著名景点	百科实体	多个
萨尔瓦多 火车站	百科实体	多个
萨尔瓦多 外文名称	其他	单个
萨尔瓦多 邮政区码	数字	单个
萨尔瓦多 政府驻地	其他	单个
萨尔瓦多 行政区类别	其他	单个
萨尔瓦多 地理位置	其他	句子
萨尔瓦多 气候条件	其他	句子
萨尔瓦多 所属地区	其他	单个
萨尔瓦多 别名	其他	多个
萨尔瓦多 机场	百科实体	单个
萨尔瓦多 方言	百科实体	单个
萨尔瓦多 下辖地区	数字+单位	多个
萨尔瓦多 市长	人名	单个
比什凯克 火车站	百科实体	多个
比什凯克 政府驻地	其他	单个
比什凯克 行政区类别	其他	单个
比什凯克 气候条件	其他	句子
比什凯克 方言	百科实体	单个
比什凯克 下辖地区	数字+单位	多个
比什凯克 市长	人名	单个
得梅因 电话区号	数字	单个
得梅因 著名景点	百科实体	多个
得梅因 火车站	百科实体	多个
得梅因 邮政区码	数字	单个
得梅因 政府驻地	其他	单个
得梅因 行政区类别	其他	单个
得梅因 地理位置	其他	句子
得梅因 气候条件	其他	句子
得梅因 面积	数字+单位	单个
得梅因 别名	其他	多个
得梅因 机场	百科实体	单个
得梅因 方言	百科实体	单个
得梅因 下辖地区	数字+单位	多个
得梅因 市长	人名	单个
里昂 市长	人名	单个
柏林 别名	其他	多个
柏林 下辖地区	数字+单位	多个
哥德堡 电话区号	数字	单个
哥德堡 著名景点	百科实体	多个
哥德堡 火车站	百科实体	多个
哥德堡 邮政区码	数字	单个
哥德堡 政府驻地	其他	单个
哥德堡 气候条件	其他	句子
哥德堡 别名	其他	多个
哥德堡 机场	百科实体	单个
哥德堡 下辖地区	数字+单位	多个
哥德堡 市长	人名	单个
基希纳乌 电话区号	数字	单个
基希纳乌 火车站	百科实体	多个
基希纳乌 邮政区码	数字	单个
基希纳乌 政府驻地	其他	单个
基希纳乌 行政区类别	其他	单个
基希纳乌 地理位置	其他	句子
基希纳乌 气候条件	其他	句子
基希纳乌 所属地区	其他	单个
基希纳乌 面积	数字+单位	单个
基希纳乌 机场	百科实体	单个
基希纳乌 方言	百科实体	单个
基希纳乌 下辖地区	数字+单位	多个
基希纳乌 市长	人名	单个
纳闽 电话区号	数字	单个
纳闽 著名景点	百科实体	多个
纳闽 火车站	百科实体	多个
纳闽 邮政区码	数字	单个
纳闽 政府驻地	其他	单个
纳闽 地理位置	其他	句子
纳闽 气候条件	其他	句子
纳闽 别名	其他	多个
纳闽 机场	百科实体	单个
纳闽 方言	百科实体	单个
纳闽 下辖地区	数字+单位	多个
纳闽 市长	人名	单个
瓦伦西亚 电话区号	数字	单个
瓦伦西亚 火车站	百科实体	多个
瓦伦西亚 邮政区码	数字	单个
瓦伦西亚 下辖地区	数字+单位	多个
雷克雅未克 火车站	百科实体	多个
特拉维夫 电话区号	数字	单个
特拉维夫 著名景点	百科实体	多个
特拉维夫 火车站	百科实体	多个
特拉维夫 外文名称	其他	单个
特拉维夫 邮政区码	数字	单个
特拉维夫 政府驻地	其他	单个
特拉维夫 行政区类别	其他	单个
特拉维夫 地理位置	其他	句子
特拉维夫 气候条件	其他	句子
特拉维夫 所属地区	其他	单个
特拉维夫 别名	其他	多个
特拉维夫 机场	百科实体	单个
特拉维夫 方言	百科实体	单个
特拉维夫 下辖地区	数字+单位	多个
特拉维夫 市长	人名	单个
堪萨斯城 著名景点	百科实体	多个
堪萨斯城 火车站	百科实体	多个
堪萨斯城 政府驻地	其他	单个
安卡拉 邮政区码	数字	单个
安卡拉 政府驻地	其他	单个
安卡拉 气候条件	其他	句子
安卡拉 面积	数字+单位	单个
安卡拉 别名	其他	多个
安卡拉 下辖地区	数字+单位	多个
安卡拉 市长	人名	单个
麦德林 电话区号	数字	单个
麦德林 火车站	百科实体	多个
麦德林 邮政区码	数字	单个
麦德林 政府驻地	其他	单个
麦德林 别名	其他	多个
麦德林 下辖地区	数字+单位	多个
麦德林 市长	人名	单个
拉巴斯 电话区号	数字	单个
拉巴斯 火车站	百科实体	多个
拉巴斯 邮政区码	数字	单个
拉巴斯 政府驻地	其他	单个
拉巴斯 气候条件	其他	句子
拉巴斯 面积	数字+单位	单个
拉巴斯 别名	其他	多个
拉巴斯 方言	百科实体	单个
拉巴斯 下辖地区	数字+单位	多个
拉巴斯 市长	人名	单个
埃里温 电话区号	数字	单个
埃里温 火车站	百科实体	多个
埃里温 邮政区码	数字	单个
埃里温 政府驻地	其他	单个
埃里温 行政区类别	其他	单个
埃里温 气候条件	其他	句子
埃里温 别名	其他	多个
埃里温 方言	百科实体	单个
埃里温 下辖地区	数字+单位	多个
埃里温 市长	人名	单个
布拉迪斯拉发 电话区号	数字	单个
布拉迪斯拉发 著名景点	百科实体	多个
布拉迪斯拉发 人口	数字+单位	单个
布拉迪斯拉发 火车站	百科实体	多个
布拉迪斯拉发 外文名称	其他	单个
布拉迪斯拉发 中文名称	其他	单个
布拉迪斯拉发 邮政区码	数字	单个
布拉迪斯拉发 政府驻地	其他	单个
布拉迪斯拉发 行政区类别	其他	单个
布拉迪斯拉发 地理位置	其他	句子
布拉迪斯拉发 气候条件	其他	句子
布拉迪斯拉发 所属地区	其他	单个
布拉迪斯拉发 面积	数字+单位	单个
布拉迪斯拉发 别名	其他	多个
布拉迪斯拉发 机场	百科实体	单个
布拉迪斯拉发 方言	百科实体	单个
布拉迪斯拉发 下辖地区	数字+单位	多个
布拉迪斯拉发 市长	人名	单个
罗利 电话区号	数字	单个
罗利 著名景点	百科实体	多个
罗利 人口	数字+单位	单个
罗利 火车站	百科实体	多个
罗利 外文名称	其他	单个
罗利 中文名称	其他	单个
罗利 邮政区码	数字	单个
罗利 政府驻地	其他	单个
罗利 行政区类别	其他	单个
罗利 地理位置	其他	句子
罗利 气候条件	其他	句子
罗利 所属地区	其他	单个
罗利 面积	数字+单位	单个
罗利 别名	其他	多个
罗利 机场	百科实体	单个
罗利 方言	百科实体	单个
罗利 下辖地区	数字+单位	多个
罗利 市长	人名	单个
哥本哈根 电话区号	数字	单个
哥本哈根 火车站	百科实体	多个
哥本哈根 邮政区码	数字	单个
哥本哈根 政府驻地	其他	单个
哥本哈根 下辖地区	数字+单位	多个
哥本哈根 市长	人名	单个
热那亚 政府驻地	其他	单个
热那亚 下辖地区	数字+单位	多个
热那亚 市长	人名	单个
奥斯陆 火车站	百科实体	多个
奥斯陆 邮政区码	数字	单个
奥斯陆 下辖地区	数字+单位	多个
奥斯陆 市长	人名	单个
槟城 电话区号	数字	单个
槟城 邮政区码	数字	单个
槟城 地理位置	其他	句子
槟城 市长	人名	单个
布鲁塞尔 火车站	百科实体	多个
布鲁塞尔 邮政区码	数字	单个
布鲁塞尔 政府驻地	其他	单个
布鲁塞尔 下辖地区	数字+单位	多个
塔林 邮政区码	数字	单个
塔林 政府驻地	其他	单个
塔林 市长	人名	单个
拉各斯 电话区号	数字	单个
拉各斯 著名景点	百科实体	多个
拉各斯 火车站	百科实体	多个
拉各斯 邮政区码	数字	单个
拉各斯 政府驻地	其他	单个
拉各斯 行政区类别	其他	单个
拉各斯 气候条件	其他	句子
拉各斯 别名	其他	多个
拉各斯 机场	百科实体	单个
拉各斯 方言	百科实体	单个
拉各斯 下辖地区	数字+单位	多个
拉各斯 市长	人名	单个
奥斯汀 电话区号	数字	单个
奥斯汀 著名景点	百科实体	多个
奥斯汀 人口	数字+单位	单个
奥斯汀 火车站	百科实体	多个
奥斯汀 外文名称	其他	单个
奥斯汀 中文名称	其他	单个
奥斯汀 邮政区码	数字	单个
奥斯汀 政府驻地	其他	单个
奥斯汀 行政区类别	其他	单个
奥斯汀 地理位置	其他	句子
奥斯汀 气候条件	其他	句子
奥斯汀 所属地区	其他	单个
奥斯汀 面积	数字+单位	单个
奥斯汀 别名	其他	多个
奥斯汀 机场	百科实体	单个
奥斯汀 方言	百科实体	单个
奥斯汀 下辖地区	数字+单位	多个
奥斯汀 市长	人名	单个
维也纳 电话区号	数字	单个
维也纳 邮政区码	数字	单个
维也纳 政府驻地	其他	单个
维也纳 下辖地区	数字+单位	多个
维也纳 市长	人名	单个
海牙 电话区号	数字	单个
海牙 著名景点	百科实体	多个
海牙 火车站	百科实体	多个
海牙 邮政区码	数字	单个
海牙 政府驻地	其他	单个
海牙 地理位置	其他	句子
海牙 气候条件	其他	句子
海牙 别名	其他	多个
海牙 机场	百科实体	单个
海牙 下辖地区	数字+单位	多个
杰克逊维尔 政府驻地	其他	单个
杰克逊维尔 别名	其他	多个
杰克逊维尔 市长	人名	单个
圣佩德罗苏拉 电话区号	数字	单个
圣佩德罗苏拉 著名景点	百科实体	多个
圣佩德罗苏拉 火车站	百科实体	多个
圣佩德罗苏拉 邮政区码	数字	单个
圣佩德罗苏拉 政府驻地	其他	单个
圣佩德罗苏拉 行政区类别	其他	单个
圣佩德罗苏拉 气候条件	其他	句子
圣佩德罗苏拉 别名	其他	多个
圣佩德罗苏拉 机场	百科实体	单个
圣佩德罗苏拉 方言	百科实体	单个
圣佩德罗苏拉 下辖地区	数字+单位	多个
圣佩德罗苏拉 市长	人名	单个
纳塔尔 火车站	百科实体	多个
纳塔尔 政府驻地	其他	单个
纳塔尔 行政区类别	其他	单个
纳塔尔 地理位置	其他	句子
纳塔尔 下辖地区	数字+单位	多个
纳塔尔 市长	人名	单个
福冈 别名	其他	多个
福冈 方言	百科实体	单个
福冈 市长	人名	单个
伊兹密尔 电话区号	数字	单个
伊兹密尔 火车站	百科实体	多个
伊兹密尔 邮政区码	数字	单个
伊兹密尔 政府驻地	其他	单个
伊兹密尔 行政区类别	其他	单个
伊兹密尔 气候条件	其他	句子
伊兹密尔 别名	其他	多个
伊兹密尔 机场	百科实体	单个
伊兹密尔 下辖地区	数字+单位	多个
伊兹密尔 市长	人名	单个
檀香山 火车站	百科实体	多个
檀香山 邮政区码	数字	单个
里尔 下辖地区	数字+单位	多个
里尔 市长	人名	单个
洛美 电话区号	数字	单个
洛美 火车站	百科实体	多个
洛美 邮政区码	数字	单个
洛美 政府驻地	其他	单个
洛美 面积	数字+单位	单个
洛美 别名	其他	多个
洛美 机场	百科实体	单个
洛美 方言	百科实体	单个
洛美 下辖地区	数字+单位	多个
洛美 市长	人名	单个
波特兰 火车站	百科实体	多个
珀斯 电话区号	数字	单个
珀斯 邮政区码	数字	单个
珀斯 政府驻地	其他	单个
珀斯 别名	其他	多个
珀斯 下辖地区	数字+单位	多个
珀斯 市长	人名	单个
渥太华 邮政区码	数字	单个
渥太华 政府驻地	其他	单个
佛罗伦萨 政府驻地	其他	单个
佛罗伦萨 行政区类别	其他	单个
佛罗伦萨 下辖地区	数字+单位	多个
罗马 电话区号	数字	单个
罗马 著名景点	百科实体	多个
罗马 火车站	百科实体	多个
罗马 外文名称	其他	单个
罗马 邮政区码	数字	单个
罗马 政府驻地	其他	单个
罗马 行政区类别	其他	单个
罗马 地理位置	其他	句子
罗马 气候条件	其他	句子
罗马 所属地区	其他	单个
罗马 别名	其他	多个
罗马 机场	百科实体	单个
罗马 方言	百科实体	单个
罗马 下辖地区	数字+单位	多个
罗马 市长	人名	单个
圣萨尔瓦多 火车站	百科实体	多个
圣萨尔瓦多 政府驻地	其他	单个
圣萨尔瓦多 别名	其他	多个
圣萨尔瓦多 方言	百科实体	单个
圣萨尔瓦多 下辖地区	数字+单位	多个
圣萨尔瓦多 市长	人名	单个
大阪 市长	人名	单个
苏黎世 邮政区码	数字	单个
苏黎世 政府驻地	其他	单个
苏黎世 下辖地区	数字+单位	多个
苏黎世 市长	人名	单个
哈里斯堡 电话区号	数字	单个
哈里斯堡 著名景点	百科实体	多个
哈里斯堡 火车站	百科实体	多个
哈里斯堡 邮政区码	数字	单个
哈里斯堡 政府驻地	其他	单个
哈里斯堡 行政区类别	其他	单个
哈里斯堡 地理位置	其他	句子
哈里斯堡 气候条件	其他	句子
哈里斯堡 面积	数字+单位	单个
哈里斯堡 别名	其他	多个
哈里斯堡 机场	百科实体	单个
哈里斯堡 方言	百科实体	单个
哈里斯堡 下辖地区	数字+单位	多个
哈里斯堡 市长	人名	单个
浦那 火车站	百科实体	多个
浦那 邮政区码	数字	单个
浦那 政府驻地	其他	单个
浦那 行政区类别	其他	单个
浦那 别名	其他	多个
浦那 机场	百科实体	单个
浦那 方言	百科实体	单个
浦那 下辖地区	数字+单位	多个
浦那 市长	人名	单个
哈博罗内 电话区号	数字	单个
哈博罗内 著名景点	百科实体	多个
哈博罗内 人口	数字+单位	单个
哈博罗内 火车站	百科实体	多个
哈博罗内 邮政区码	数字	单个
哈博罗内 政府驻地	其他	单个
哈博罗内 气候条件	其他	句子
哈博罗内 别名	其他	多个
哈博罗内 机场	百科实体	单个
哈博罗内 方言	百科实体	单个
哈博罗内 下辖地区	数字+单位	多个
哈博罗内 市长	人名	单个
加拉加斯 电话区号	数字	单个
加拉加斯 著名景点	百科实体	多个
加拉加斯 火车站	百科实体	多个
加拉加斯 邮政区码	数字	单个
加拉加斯 政府驻地	其他	单个
加拉加斯 地理位置	其他	句子
加拉加斯 气候条件	其他	句子
加拉加斯 下辖地区	数字+单位	多个
加拉加斯 市长	人名	单个
蒙特利尔 政府驻地	其他	单个
蒙特利尔 下辖地区	数字+单位	多个
温尼伯 火车站	百科实体	多个
温尼伯 邮政区码	数字	单个
温尼伯 下辖地区	数字+单位	多个
温尼伯 市长	人名	单个
蒙特雷 电话区号	数字	单个
蒙特雷 著名景点	百科实体	多个
蒙特雷 火车站	百科实体	多个
蒙特雷 外文名称	其他	单个
蒙特雷 中文名称	其他	单个
蒙特雷 邮政区码	数字	单个
蒙特雷 政府驻地	其他	单个
蒙特雷 行政区类别	其他	单个
蒙特雷 地理位置	其他	句子
蒙特雷 气候条件	其他	句子
蒙特雷 所属地区	其他	单个
蒙特雷 别名	其他	多个
蒙特雷 机场	百科实体	单个
蒙特雷 方言	百科实体	单个
蒙特雷 下辖地区	数字+单位	多个
耶路撒冷 下辖地区	数字+单位	多个
新加坡 著名景点	百科实体	多个
新加坡 外文名称	其他	单个
新加坡 邮政区码	数字	单个
新加坡 政府驻地	其他	单个
新加坡 行政区类别	其他	单个
新加坡 地理位置	其他	句子
新加坡 气候条件	其他	句子
新加坡 所属地区	其他	单个
新加坡 别名	其他	多个
新加坡 方言	百科实体	单个
新加坡 下辖地区	数字+单位	多个
新加坡 市长	人名	单个
阿里格尔 电话区号	数字	单个
阿里格尔 著名景点	百科实体	多个
阿里格尔 火车站	百科实体	多个
阿里格尔 外文名称	其他	单个
阿里格尔 中文名称	其他	单个
阿里格尔 邮政区码	数字	单个
阿里格尔 政府驻地	其他	单个
阿里格尔 行政区类别	其他	单个
阿里格尔 地理位置	其他	句子
阿里格尔 气候条件	其他	句子
阿里格尔 面积	数字+单位	单个
阿里格尔 别名	其他	多个
阿里格尔 机场	百科实体	单个
阿里格尔 方言	百科实体	单个
阿里格尔 下辖地区	数字+单位	多个
阿里格尔 市长	人名	单个
卡拉奇 电话区号	数字	单个
卡拉奇 著名景点	百科实体	多个
卡拉奇 火车站	百科实体	多个
卡拉奇 邮政区码	数字	单个
卡拉奇 政府驻地	其他	单个
卡拉奇 行政区类别	其他	单个
卡拉奇 地理位置	其他	句子
卡拉奇 气候条件	其他	句子
卡拉奇 别名	其他	多个
卡拉奇 机场	百科实体	单个
卡拉奇 下辖地区	数字+单位	多个
卡拉奇 市长	人名	单个
墨西哥城 火车站	百科实体	多个
墨西哥城 政府驻地	其他	单个
墨西哥城 下辖地区	数字+单位	多个
墨西哥城 市长	人名	单个
艾哈迈达巴德 电话区号	数字	单个
艾哈迈达巴德 火车站	百科实体	多个
艾哈迈达巴德 邮政区码	数字	单个
艾哈迈达巴德 政府驻地	其他	单个
艾哈迈达巴德 行政区类别	其他	单个
艾哈迈达巴德 地理位置	其他	句子
艾哈迈达巴德 气候条件	其他	句子
艾哈迈达巴德 面积	数字+单位	单个
艾哈迈达巴德 机场	百科实体	单个
艾哈迈达巴德 方言	百科实体	单个
艾哈迈达巴德 下辖地区	数字+单位	多个
艾哈迈达巴德 市长	人名	单个
鹿特丹 电话区号	数字	单个
鹿特丹 火车站	百科实体	多个
鹿特丹 邮政区码	数字	单个
鹿特丹 政府驻地	其他	单个
鹿特丹 行政区类别	其他	单个
鹿特丹 地理位置	其他	句子
鹿特丹 别名	其他	多个
鹿特丹 机场	百科实体	单个
鹿特丹 方言	百科实体	单个
鹿特丹 下辖地区	数字+单位	多个
凤凰城 邮政区码	数字	单个
凤凰城 政府驻地	其他	单个
凤凰城 行政区类别	其他	单个
凤凰城 气候条件	其他	句子
凤凰城 所属地区	其他	单个
凤凰城 别名	其他	多个
凤凰城 下辖地区	数字+单位	多个
凤凰城 市长	人名	单个
