喀拉海 平均水深	数字+单位	单个
喀拉海 海水温度	数字+单位	单个
喀拉海 周边国家	百科实体	多个
喀拉海 最深处	数字+单位	单个
萨武海 平均水深	数字+单位	单个
萨武海 地理位置	其他	句子
萨武海 海水温度	数字+单位	单个
萨武海 周边国家	百科实体	多个
萨武海 最深处	数字+单位	单个
加勒比海 地理位置	其他	句子
加勒比海 海水温度	数字+单位	单个
加勒比海 最深处	数字+单位	单个
爱尔兰海 海水温度	数字+单位	单个
爱尔兰海 周边国家	百科实体	多个
爱尔兰海 最深处	数字+单位	单个
瓦登海 平均水深	数字+单位	单个
瓦登海 地理位置	其他	句子
瓦登海 海水温度	数字+单位	单个
瓦登海 面积	数字+单位	单个
瓦登海 周边国家	百科实体	多个
瓦登海 最深处	数字+单位	单个
墨西哥湾 平均水深	数字+单位	单个
墨西哥湾 地理位置	其他	句子
墨西哥湾 最深处	数字+单位	单个
喀拉海峡 平均水深	数字+单位	单个
喀拉海峡 地理位置	其他	句子
喀拉海峡 海水温度	数字+单位	单个
喀拉海峡 面积	数字+单位	单个
喀拉海峡 周边国家	百科实体	多个
喀拉海峡 最深处	数字+单位	单个
爱琴海 平均水深	数字+单位	单个
爱琴海 地理位置	其他	句子
红海 平均水深	数字+单位	单个
红海 地理位置	其他	句子
德雷克海峡 海水温度	数字+单位	单个
德雷克海峡 面积	数字+单位	单个
德雷克海峡 周边国家	百科实体	多个
德雷克海峡 最深处	数字+单位	单个
格陵兰海 周边国家	百科实体	多个
黄海 平均水深	数字+单位	单个
黄海 地理位置	其他	句子
黄海 海水温度	数字+单位	单个
黄海 面积	数字+单位	单个
黄海 周边国家	百科实体	多个
黄海 最深处	数字+单位	单个
俾斯麦海 平均水深	数字+单位	单个
别林斯高晋海 平均水深	数字+单位	单个
别林斯高晋海 周边国家	百科实体	多个
马尾藻海 平均水深	数字+单位	单个
马尾藻海 地理位置	其他	句子
马尾藻海 海水温度	数字+单位	单个
马尾藻海 周边国家	百科实体	多个
马尾藻海 最深处	数字+单位	单个
巴芬湾 平均水深	数字+单位	单个
巴芬湾 地理位置	其他	句子
巴芬湾 海水温度	数字+单位	单个
巴芬湾 周边国家	百科实体	多个
巴芬湾 最深处	数字+单位	单个
巴芬湾 外文名	其他	多个
锡德拉湾 平均水深	数字+单位	单个
锡德拉湾 地理位置	其他	句子
锡德拉湾 海水温度	数字+单位	单个
锡德拉湾 面积	数字+单位	单个
锡德拉湾 周边国家	百科实体	多个
锡德拉湾 最深处	数字+单位	单个
利古里亚海 平均水深	数字+单位	单个
利古里亚海 地理位置	其他	句子
利古里亚海 海水温度	数字+单位	单个
利古里亚海 周边国家	百科实体	多个
利古里亚海 最深处	数字+单位	单个
卡奔塔利亚湾 平均水深	数字+单位	单个
卡奔塔利亚湾 海水温度	数字+单位	单个
卡奔塔利亚湾 周边国家	百科实体	多个
卡奔塔利亚湾 最深处	数字+单位	单个
保和海 平均水深	数字+单位	单个
保和海 海水温度	数字+单位	单个
保和海 面积	数字+单位	单个
保和海 周边国家	百科实体	多个
保和海 最深处	数字+单位	单个
挪威海 平均水深	数字+单位	单个
挪威海 地理位置	其他	句子
挪威海 海水温度	数字+单位	单个
挪威海 最深处	数字+单位	单个
黎凡特海 平均水深	数字+单位	单个
黎凡特海 地理位置	其他	句子
黎凡特海 海水温度	数字+单位	单个
黎凡特海 面积	数字+单位	单个
黎凡特海 周边国家	百科实体	多个
黎凡特海 最深处	数字+单位	单个
黎凡特海 外文名	其他	多个
阿蒙森湾 平均水深	数字+单位	单个
阿蒙森湾 地理位置	其他	句子
巴利阿里海 平均水深	数字+单位	单个
凯尔特海 平均水深	数字+单位	单个
凯尔特海 地理位置	其他	句子
凯尔特海 海水温度	数字+单位	单个
凯尔特海 面积	数字+单位	单个
凯尔特海 周边国家	百科实体	多个
凯尔特海 最深处	数字+单位	单个
委内瑞拉湾 平均水深	数字+单位	单个
委内瑞拉湾 地理位置	其他	句子
委内瑞拉湾 海水温度	数字+单位	单个
委内瑞拉湾 面积	数字+单位	单个
委内瑞拉湾 周边国家	百科实体	多个
委内瑞拉湾 最深处	数字+单位	单个
科罗海 平均水深	数字+单位	单个
科罗海 地理位置	其他	句子
科罗海 海水温度	数字+单位	单个
科罗海 面积	数字+单位	单个
科罗海 周边国家	百科实体	多个
科罗海 最深处	数字+单位	单个
阿蒙森海 地理位置	其他	句子
阿蒙森海 面积	数字+单位	单个
阿蒙森海 周边国家	百科实体	多个
北海 平均水深	数字+单位	单个
北海 海水温度	数字+单位	单个
北海 周边国家	百科实体	多个
北海 最深处	数字+单位	单个
地中海 平均水深	数字+单位	单个
地中海 地理位置	其他	句子
地中海 海水温度	数字+单位	单个
地中海 周边国家	百科实体	多个
地中海 最深处	数字+单位	单个
东西伯利亚海 平均水深	数字+单位	单个
东西伯利亚海 地理位置	其他	句子
芬兰湾 平均水深	数字+单位	单个
芬兰湾 地理位置	其他	句子
芬兰湾 海水温度	数字+单位	单个
芬兰湾 周边国家	百科实体	多个
芬兰湾 最深处	数字+单位	单个
弗洛勒斯海 平均水深	数字+单位	单个
弗洛勒斯海 地理位置	其他	句子
弗洛勒斯海 海水温度	数字+单位	单个
弗洛勒斯海 周边国家	百科实体	多个
弗洛勒斯海 最深处	数字+单位	单个
阿尔沃兰海 平均水深	数字+单位	单个
阿尔沃兰海 海水温度	数字+单位	单个
阿尔沃兰海 周边国家	百科实体	多个
阿尔沃兰海 最深处	数字+单位	单个
马尔马拉海 平均水深	数字+单位	单个
马尔马拉海 地理位置	其他	句子
英吉利海峡 平均水深	数字+单位	单个
英吉利海峡 地理位置	其他	句子
英吉利海峡 海水温度	数字+单位	单个
英吉利海峡 周边国家	百科实体	多个
英吉利海峡 最深处	数字+单位	单个
博滕海 平均水深	数字+单位	单个
博滕海 地理位置	其他	句子
博滕海 海水温度	数字+单位	单个
博滕海 面积	数字+单位	单个
博滕海 周边国家	百科实体	多个
博滕海 最深处	数字+单位	单个
峇里海 平均水深	数字+单位	单个
峇里海 海水温度	数字+单位	单个
峇里海 周边国家	百科实体	多个
峇里海 最深处	数字+单位	单个
拉普捷夫海 平均水深	数字+单位	单个
拉普捷夫海 地理位置	其他	句子
拉普捷夫海 海水温度	数字+单位	单个
拉普捷夫海 周边国家	百科实体	多个
拉普捷夫海 最深处	数字+单位	单个
威德尔海 周边国家	百科实体	多个
威德尔海 最深处	数字+单位	单个
阿根廷海 地理位置	其他	句子
阿根廷海 海水温度	数字+单位	单个
阿根廷海 周边国家	百科实体	多个
阿根廷海 最深处	数字+单位	单个
阿根廷海 外文名	其他	多个
珊瑚海 平均水深	数字+单位	单个
珊瑚海 地理位置	其他	句子
珊瑚海 海水温度	数字+单位	单个
珊瑚海 面积	数字+单位	单个
珊瑚海 周边国家	百科实体	多个
珊瑚海 最深处	数字+单位	单个
珊瑚海 外文名	其他	多个
丹麦海峡 平均水深	数字+单位	单个
丹麦海峡 地理位置	其他	句子
丹麦海峡 海水温度	数字+单位	单个
丹麦海峡 面积	数字+单位	单个
丹麦海峡 周边国家	百科实体	多个
丹麦海峡 最深处	数字+单位	单个
亚速海 平均水深	数字+单位	单个
亚速海 地理位置	其他	句子
亚速海 海水温度	数字+单位	单个
亚速海 周边国家	百科实体	多个
亚速海 最深处	数字+单位	单个
莫桑比克海峡 平均水深	数字+单位	单个
莫桑比克海峡 地理位置	其他	句子
莫桑比克海峡 海水温度	数字+单位	单个
莫桑比克海峡 面积	数字+单位	单个
莫桑比克海峡 周边国家	百科实体	多个
莫桑比克海峡 最深处	数字+单位	单个
哈马黑拉海 平均水深	数字+单位	单个
哈马黑拉海 地理位置	其他	句子
哈马黑拉海 海水温度	数字+单位	单个
哈马黑拉海 周边国家	百科实体	多个
哈马黑拉海 最深处	数字+单位	单个
哈马黑拉海 外文名	其他	多个
所罗门海 平均水深	数字+单位	单个
所罗门海 地理位置	其他	句子
所罗门海 最深处	数字+单位	单个
芬迪湾 平均水深	数字+单位	单个
芬迪湾 地理位置	其他	句子
芬迪湾 海水温度	数字+单位	单个
芬迪湾 周边国家	百科实体	多个
芬迪湾 最深处	数字+单位	单个
孟加拉湾 地理位置	其他	句子
孟加拉湾 周边国家	百科实体	多个
孟加拉湾 最深处	数字+单位	单个
菲律宾海 平均水深	数字+单位	单个
菲律宾海 周边国家	百科实体	多个
哈德森湾 平均水深	数字+单位	单个
哈德森湾 地理位置	其他	句子
古斯塔夫阿道夫王子海 平均水深	数字+单位	单个
古斯塔夫阿道夫王子海 地理位置	其他	句子
古斯塔夫阿道夫王子海 海水温度	数字+单位	单个
古斯塔夫阿道夫王子海 面积	数字+单位	单个
古斯塔夫阿道夫王子海 周边国家	百科实体	多个
古斯塔夫阿道夫王子海 最深处	数字+单位	单个
古斯塔夫阿道夫王子海 外文名	其他	多个
波罗的海 平均水深	数字+单位	单个
波罗的海 地理位置	其他	句子
波罗的海 周边国家	百科实体	多个
缅因湾 平均水深	数字+单位	单个
缅因湾 地理位置	其他	句子
缅因湾 海水温度	数字+单位	单个
缅因湾 面积	数字+单位	单个
缅因湾 周边国家	百科实体	多个
缅因湾 最深处	数字+单位	单个
缅因湾 外文名	其他	多个
巴斯海峡 平均水深	数字+单位	单个
巴斯海峡 地理位置	其他	句子
巴斯海峡 海水温度	数字+单位	单个
巴斯海峡 面积	数字+单位	单个
巴斯海峡 周边国家	百科实体	多个
巴斯海峡 最深处	数字+单位	单个
里加湾 平均水深	数字+单位	单个
里加湾 海水温度	数字+单位	单个
里加湾 周边国家	百科实体	多个
里加湾 最深处	数字+单位	单个
亚丁湾 最深处	数字+单位	单个
爪哇海 平均水深	数字+单位	单个
爪哇海 地理位置	其他	句子
爪哇海 海水温度	数字+单位	单个
阿拉斯加湾 平均水深	数字+单位	单个
阿拉斯加湾 地理位置	其他	句子
阿拉斯加湾 海水温度	数字+单位	单个
阿拉斯加湾 周边国家	百科实体	多个
阿拉斯加湾 最深处	数字+单位	单个
伯朝拉海 地理位置	其他	句子
伯朝拉海 海水温度	数字+单位	单个
伯朝拉海 面积	数字+单位	单个
伯朝拉海 周边国家	百科实体	多个
詹姆斯湾 平均水深	数字+单位	单个
詹姆斯湾 地理位置	其他	句子
詹姆斯湾 海水温度	数字+单位	单个
詹姆斯湾 面积	数字+单位	单个
詹姆斯湾 周边国家	百科实体	多个
詹姆斯湾 最深处	数字+单位	单个
比斯开湾 海水温度	数字+单位	单个
比斯开湾 周边国家	百科实体	多个
比斯开湾 最深处	数字+单位	单个
坎佩切湾 平均水深	数字+单位	单个
坎佩切湾 地理位置	其他	句子
坎佩切湾 海水温度	数字+单位	单个
坎佩切湾 周边国家	百科实体	多个
坎佩切湾 最深处	数字+单位	单个
白令海 地理位置	其他	句子
白令海 最深处	数字+单位	单个
赫布里底海 地理位置	其他	句子
赫布里底海 海水温度	数字+单位	单个
赫布里底海 周边国家	百科实体	多个
赫布里底海 最深处	数字+单位	单个
赫布里底海 外文名	其他	多个
克里特海 平均水深	数字+单位	单个
克里特海 地理位置	其他	句子
克里特海 海水温度	数字+单位	单个
克里特海 面积	数字+单位	单个
克里特海 周边国家	百科实体	多个
克里特海 最深处	数字+单位	单个
斯科舍海 平均水深	数字+单位	单个
斯科舍海 地理位置	其他	句子
斯科舍海 海水温度	数字+单位	单个
米沙鄢海 平均水深	数字+单位	单个
米沙鄢海 地理位置	其他	句子
波弗特海 平均水深	数字+单位	单个
波弗特海 海水温度	数字+单位	单个
波弗特海 周边国家	百科实体	多个
波弗特海 最深处	数字+单位	单个
波的尼亚湾 平均水深	数字+单位	单个
波的尼亚湾 海水温度	数字+单位	单个
波的尼亚湾 周边国家	百科实体	多个
厄勒海峡 平均水深	数字+单位	单个
厄勒海峡 地理位置	其他	句子
厄勒海峡 海水温度	数字+单位	单个
厄勒海峡 面积	数字+单位	单个
厄勒海峡 周边国家	百科实体	多个
厄勒海峡 最深处	数字+单位	单个
加利福尼亚湾 平均水深	数字+单位	单个
加利福尼亚湾 地理位置	其他	句子
第勒尼安海 平均水深	数字+单位	单个
第勒尼安海 地理位置	其他	句子
第勒尼安海 海水温度	数字+单位	单个
第勒尼安海 面积	数字+单位	单个
第勒尼安海 周边国家	百科实体	多个
塔斯曼海 平均水深	数字+单位	单个
塔斯曼海 地理位置	其他	句子
巴伦支海 地理位置	其他	句子
巴伦支海 海水温度	数字+单位	单个
巴伦支海 最深处	数字+单位	单个
泰国湾 平均水深	数字+单位	单个
泰国湾 地理位置	其他	句子
泰国湾 海水温度	数字+单位	单个
泰国湾 周边国家	百科实体	多个
泰国湾 最深处	数字+单位	单个
塞兰海 平均水深	数字+单位	单个
塞兰海 海水温度	数字+单位	单个
塞兰海 周边国家	百科实体	多个
塞兰海 最深处	数字+单位	单个
爱奥尼亚海 平均水深	数字+单位	单个
爱奥尼亚海 地理位置	其他	句子
爱奥尼亚海 海水温度	数字+单位	单个
爱奥尼亚海 面积	数字+单位	单个
爱奥尼亚海 周边国家	百科实体	多个
爱奥尼亚海 最深处	数字+单位	单个
波斯湾 平均水深	数字+单位	单个
波斯湾 海水温度	数字+单位	单个
波斯湾 面积	数字+单位	单个
波斯湾 周边国家	百科实体	多个
波斯湾 最深处	数字+单位	单个
卡莫特斯海 平均水深	数字+单位	单个
卡莫特斯海 地理位置	其他	句子
卡莫特斯海 海水温度	数字+单位	单个
卡莫特斯海 周边国家	百科实体	多个
卡莫特斯海 最深处	数字+单位	单个
卡莫特斯海 外文名	其他	多个
楚科奇海 地理位置	其他	句子
楚科奇海 最深处	数字+单位	单个
阿曼湾 平均水深	数字+单位	单个
阿曼湾 地理位置	其他	句子
阿曼湾 面积	数字+单位	单个
阿曼湾 最深处	数字+单位	单个
西里伯斯海 平均水深	数字+单位	单个
西里伯斯海 地理位置	其他	句子
西里伯斯海 海水温度	数字+单位	单个
西里伯斯海 面积	数字+单位	单个
西里伯斯海 周边国家	百科实体	多个
西里伯斯海 最深处	数字+单位	单个
拉布拉多海 平均水深	数字+单位	单个
拉布拉多海 海水温度	数字+单位	单个
拉布拉多海 周边国家	百科实体	多个
亚得里亚海 平均水深	数字+单位	单个
亚得里亚海 地理位置	其他	句子
亚得里亚海 海水温度	数字+单位	单个
亚得里亚海 面积	数字+单位	单个
亚得里亚海 周边国家	百科实体	多个
亚得里亚海 最深处	数字+单位	单个
大澳洲湾 平均水深	数字+单位	单个
大澳洲湾 地理位置	其他	句子
大澳洲湾 海水温度	数字+单位	单个
大澳洲湾 面积	数字+单位	单个
大澳洲湾 周边国家	百科实体	多个
大澳洲湾 最深处	数字+单位	单个
大澳洲湾 外文名	其他	多个
东海 地理位置	其他	句子
安达曼海 地理位置	其他	句子
罗斯海 周边国家	百科实体	多个
黑海 地理位置	其他	句子
黑海 海水温度	数字+单位	单个
黑海 最深处	数字+单位	单个
濑户内海 平均水深	数字+单位	单个
濑户内海 地理位置	其他	句子
濑户内海 海水温度	数字+单位	单个
濑户内海 面积	数字+单位	单个
濑户内海 周边国家	百科实体	多个
濑户内海 最深处	数字+单位	单个
阿拉伯海 平均水深	数字+单位	单个
阿拉伯海 地理位置	其他	句子
阿拉伯海 海水温度	数字+单位	单个
阿拉伯海 周边国家	百科实体	多个
渤海 地理位置	其他	句子
渤海 周边国家	百科实体	多个
渤海 最深处	数字+单位	单个
马鲁古海 平均水深	数字+单位	单个
马鲁古海 地理位置	其他	句子
班达海 平均水深	数字+单位	单个
奇里乞亚 平均水深	数字+单位	单个
奇里乞亚 地理位置	其他	句子
奇里乞亚 海水温度	数字+单位	单个
奇里乞亚 面积	数字+单位	单个
奇里乞亚 周边国家	百科实体	多个
奇里乞亚 最深处	数字+单位	单个
戴维斯海峡 地理位置	其他	句子
戴维斯海峡 海水温度	数字+单位	单个
戴维斯海峡 面积	数字+单位	单个
戴维斯海峡 周边国家	百科实体	多个
戴维斯海峡 最深处	数字+单位	单个
切萨皮克湾 平均水深	数字+单位	单个
切萨皮克湾 海水温度	数字+单位	单个
切萨皮克湾 周边国家	百科实体	多个
切萨皮克湾 最深处	数字+单位	单个
圣文森特湾 平均水深	数字+单位	单个
圣文森特湾 地理位置	其他	句子
圣文森特湾 海水温度	数字+单位	单个
圣文森特湾 面积	数字+单位	单个
圣文森特湾 周边国家	百科实体	多个
圣文森特湾 最深处	数字+单位	单个
林肯海 平均水深	数字+单位	单个
林肯海 面积	数字+单位	单个
林肯海 最深处	数字+单位	单个
阿拉弗拉海 平均水深	数字+单位	单个
阿拉弗拉海 海水温度	数字+单位	单个
阿拉弗拉海 周边国家	百科实体	多个
阿拉弗拉海 最深处	数字+单位	单个
鄂霍次克海 海水温度	数字+单位	单个
鄂霍次克海 周边国家	百科实体	多个
帝汶海 平均水深	数字+单位	单个
帝汶海 地理位置	其他	句子
帝汶海 最深处	数字+单位	单个
锡布延海 平均水深	数字+单位	单个
锡布延海 海水温度	数字+单位	单个
锡布延海 周边国家	百科实体	多个
锡布延海 最深处	数字+单位	单个
几内亚湾 平均水深	数字+单位	单个
几内亚湾 海水温度	数字+单位	单个
几内亚湾 面积	数字+单位	单个
几内亚湾 周边国家	百科实体	多个
几内亚湾 最深处	数字+单位	单个
日本海 地理位置	其他	句子
日本海 海水温度	数字+单位	单个
日本海 周边国家	百科实体	多个
日本海 最深处	数字+单位	单个
