科罗拉多河 中文名称	其他	单个
科罗拉多河 河长	数字+单位	单个
科罗拉多河 河流面积	数字+单位	单个
科罗拉多河 别称	其他	单个
科罗拉多河 发源地	其他	句子
科罗拉多河 流经地区	其他	多个
科罗拉多河 英文名称	其他	多个
科罗拉多河 所属水系	其他	单个
加拿大河 地理位置	其他	单个
加拿大河 主要支流	百科实体	多个
加拿大河 中文名称	其他	单个
加拿大河 河长	数字+单位	单个
加拿大河 河流面积	数字+单位	单个
加拿大河 别称	其他	单个
加拿大河 发源地	其他	句子
加拿大河 流经地区	其他	多个
加拿大河 英文名称	其他	多个
加拿大河 所属水系	其他	单个
顿河 地理位置	其他	单个
顿河 平均流量	数字+单位	单个
顿河 主要支流	百科实体	多个
顿河 中文名称	其他	单个
顿河 河长	数字+单位	单个
顿河 河流面积	数字+单位	单个
顿河 别称	其他	单个
顿河 发源地	其他	句子
顿河 外文名	其他	多个
顿河 流经地区	其他	多个
顿河 英文名称	其他	多个
顿河 所属水系	其他	单个
阿纳德尔河 流域面积	数字+单位	单个
阿纳德尔河 别称	其他	单个
阿纳德尔河 发源地	其他	句子
阿纳德尔河 外文名	其他	多个
阿纳德尔河 流经地区	其他	多个
阿纳德尔河 所属水系	其他	单个
大黑河 平均流量	数字+单位	单个
大黑河 主要支流	百科实体	多个
大黑河 中文名称	其他	单个
大黑河 河长	数字+单位	单个
大黑河 河流面积	数字+单位	单个
大黑河 别称	其他	单个
大黑河 外文名	其他	多个
大黑河 英文名称	其他	多个
奥里诺科河 平均流量	数字+单位	单个
奥里诺科河 主要支流	百科实体	多个
奥里诺科河 流域面积	数字+单位	单个
奥里诺科河 河长	数字+单位	单个
奥里诺科河 河流面积	数字+单位	单个
奥里诺科河 别称	其他	单个
奥里诺科河 发源地	其他	句子
奥里诺科河 流经地区	其他	多个
奥里诺科河 英文名称	其他	多个
奥里诺科河 所属水系	其他	单个
黑龙江 平均流量	数字+单位	单个
黑龙江 主要支流	百科实体	多个
黑龙江 流域面积	数字+单位	单个
黑龙江 河长	数字+单位	单个
黑龙江 河流面积	数字+单位	单个
黑龙江 别称	其他	单个
黑龙江 发源地	其他	句子
黑龙江 流经地区	其他	多个
黑龙江 英文名称	其他	多个
黑龙江 所属水系	其他	单个
闽江 平均流量	数字+单位	单个
闽江 河流面积	数字+单位	单个
闽江 别称	其他	单个
闽江 外文名	其他	多个
闽江 英文名称	其他	多个
海河 地理位置	其他	单个
海河 平均流量	数字+单位	单个
海河 中文名称	其他	单个
海河 河长	数字+单位	单个
海河 河流面积	数字+单位	单个
海河 别称	其他	单个
海河 发源地	其他	句子
海河 外文名	其他	多个
海河 英文名称	其他	多个
尼罗河 平均流量	数字+单位	单个
尼罗河 主要支流	百科实体	多个
尼罗河 中文名称	其他	单个
尼罗河 流域面积	数字+单位	单个
尼罗河 河长	数字+单位	单个
尼罗河 河流面积	数字+单位	单个
尼罗河 别称	其他	单个
尼罗河 流经地区	其他	多个
尼罗河 英文名称	其他	多个
尼罗河 所属水系	其他	单个
阿姆河 地理位置	其他	单个
阿姆河 主要支流	百科实体	多个
阿姆河 中文名称	其他	单个
阿姆河 流域面积	数字+单位	单个
阿姆河 河长	数字+单位	单个
阿姆河 河流面积	数字+单位	单个
阿姆河 别称	其他	单个
阿姆河 发源地	其他	句子
阿姆河 流经地区	其他	多个
阿姆河 英文名称	其他	多个
阿姆河 所属水系	其他	单个
叶尼塞河 流域面积	数字+单位	单个
叶尼塞河 别称	其他	单个
叶尼塞河 外文名	其他	多个
卡斯科奎姆河 地理位置	其他	单个
卡斯科奎姆河 主要支流	百科实体	多个
卡斯科奎姆河 流域面积	数字+单位	单个
卡斯科奎姆河 别称	其他	单个
卡斯科奎姆河 外文名	其他	多个
卡斯科奎姆河 流经地区	其他	多个
卡斯科奎姆河 所属水系	其他	单个
奇纳布河 地理位置	其他	单个
奇纳布河 平均流量	数字+单位	单个
奇纳布河 主要支流	百科实体	多个
奇纳布河 中文名称	其他	单个
奇纳布河 河流面积	数字+单位	单个
奇纳布河 别称	其他	单个
奇纳布河 发源地	其他	句子
奇纳布河 流经地区	其他	多个
奇纳布河 英文名称	其他	多个
奇纳布河 所属水系	其他	单个
北江 地理位置	其他	单个
北江 平均流量	数字+单位	单个
北江 主要支流	百科实体	多个
北江 中文名称	其他	单个
北江 流域面积	数字+单位	单个
北江 河流面积	数字+单位	单个
北江 外文名	其他	多个
北江 流经地区	其他	多个
北江 英文名称	其他	多个
赞比西河 流域面积	数字+单位	单个
赞比西河 外文名	其他	多个
科雷马河 地理位置	其他	单个
科雷马河 平均流量	数字+单位	单个
科雷马河 主要支流	百科实体	多个
科雷马河 中文名称	其他	单个
科雷马河 河流面积	数字+单位	单个
科雷马河 别称	其他	单个
科雷马河 发源地	其他	句子
科雷马河 流经地区	其他	多个
科雷马河 英文名称	其他	多个
科雷马河 所属水系	其他	单个
讷尔默达河 主要支流	百科实体	多个
讷尔默达河 流域面积	数字+单位	单个
讷尔默达河 外文名	其他	多个
讷尔默达河 所属水系	其他	单个
克鲁伦河 地理位置	其他	单个
克鲁伦河 平均流量	数字+单位	单个
克鲁伦河 主要支流	百科实体	多个
克鲁伦河 流域面积	数字+单位	单个
克鲁伦河 别称	其他	单个
克鲁伦河 外文名	其他	多个
渭河 平均流量	数字+单位	单个
渭河 流域面积	数字+单位	单个
渭河 外文名	其他	多个
渭河 英文名称	其他	多个
怀特河 地理位置	其他	单个
怀特河 平均流量	数字+单位	单个
怀特河 主要支流	百科实体	多个
怀特河 中文名称	其他	单个
怀特河 流域面积	数字+单位	单个
怀特河 河长	数字+单位	单个
怀特河 河流面积	数字+单位	单个
怀特河 别称	其他	单个
怀特河 发源地	其他	句子
怀特河 流经地区	其他	多个
怀特河 英文名称	其他	多个
怀特河 所属水系	其他	单个
鄂毕河 流域面积	数字+单位	单个
鄂毕河 外文名	其他	多个
圣劳伦斯河 平均流量	数字+单位	单个
圣劳伦斯河 主要支流	百科实体	多个
圣劳伦斯河 流域面积	数字+单位	单个
圣劳伦斯河 河流面积	数字+单位	单个
圣劳伦斯河 别称	其他	单个
圣劳伦斯河 发源地	其他	句子
圣劳伦斯河 外文名	其他	多个
圣劳伦斯河 流经地区	其他	多个
欣古河 流域面积	数字+单位	单个
欣古河 别称	其他	单个
欣古河 外文名	其他	多个
欣古河 流经地区	其他	多个
欣古河 英文名称	其他	多个
疏勒河 地理位置	其他	单个
疏勒河 平均流量	数字+单位	单个
疏勒河 主要支流	百科实体	多个
疏勒河 中文名称	其他	单个
疏勒河 河长	数字+单位	单个
疏勒河 河流面积	数字+单位	单个
疏勒河 别称	其他	单个
疏勒河 外文名	其他	多个
疏勒河 流经地区	其他	多个
疏勒河 英文名称	其他	多个
疏勒河 所属水系	其他	单个
伊希姆河 地理位置	其他	单个
伊希姆河 平均流量	数字+单位	单个
伊希姆河 主要支流	百科实体	多个
伊希姆河 河长	数字+单位	单个
伊希姆河 河流面积	数字+单位	单个
伊希姆河 别称	其他	单个
伊希姆河 流经地区	其他	多个
伊希姆河 英文名称	其他	多个
伊希姆河 所属水系	其他	单个
萨尔温江 地理位置	其他	单个
萨尔温江 平均流量	数字+单位	单个
萨尔温江 主要支流	百科实体	多个
萨尔温江 中文名称	其他	单个
萨尔温江 河长	数字+单位	单个
萨尔温江 河流面积	数字+单位	单个
萨尔温江 别称	其他	单个
萨尔温江 发源地	其他	句子
萨尔温江 流经地区	其他	多个
萨尔温江 英文名称	其他	多个
萨尔温江 所属水系	其他	单个
特利斯皮里斯河 地理位置	其他	单个
特利斯皮里斯河 平均流量	数字+单位	单个
特利斯皮里斯河 主要支流	百科实体	多个
特利斯皮里斯河 流域面积	数字+单位	单个
特利斯皮里斯河 河流面积	数字+单位	单个
特利斯皮里斯河 别称	其他	单个
特利斯皮里斯河 发源地	其他	句子
特利斯皮里斯河 外文名	其他	多个
特利斯皮里斯河 英文名称	其他	多个
奥列尼奥克河 平均流量	数字+单位	单个
奥列尼奥克河 主要支流	百科实体	多个
奥列尼奥克河 河长	数字+单位	单个
奥列尼奥克河 河流面积	数字+单位	单个
奥列尼奥克河 别称	其他	单个
奥列尼奥克河 发源地	其他	句子
奥列尼奥克河 流经地区	其他	多个
奥列尼奥克河 英文名称	其他	多个
奥列尼奥克河 所属水系	其他	单个
九龙江 地理位置	其他	单个
九龙江 平均流量	数字+单位	单个
九龙江 主要支流	百科实体	多个
九龙江 中文名称	其他	单个
九龙江 河流面积	数字+单位	单个
九龙江 别称	其他	单个
九龙江 发源地	其他	句子
九龙江 流经地区	其他	多个
九龙江 英文名称	其他	多个
九龙江 所属水系	其他	单个
锡尔河 主要支流	百科实体	多个
锡尔河 河长	数字+单位	单个
锡尔河 河流面积	数字+单位	单个
锡尔河 别称	其他	单个
锡尔河 发源地	其他	句子
锡尔河 流经地区	其他	多个
锡尔河 英文名称	其他	多个
锡尔河 所属水系	其他	单个
阿克苏河 平均流量	数字+单位	单个
阿克苏河 主要支流	百科实体	多个
阿克苏河 中文名称	其他	单个
阿克苏河 流域面积	数字+单位	单个
阿克苏河 河长	数字+单位	单个
阿克苏河 河流面积	数字+单位	单个
阿克苏河 别称	其他	单个
阿克苏河 发源地	其他	句子
阿克苏河 流经地区	其他	多个
阿克苏河 英文名称	其他	多个
阿克苏河 所属水系	其他	单个
马更些河 地理位置	其他	单个
马更些河 主要支流	百科实体	多个
马更些河 中文名称	其他	单个
马更些河 流域面积	数字+单位	单个
马更些河 河长	数字+单位	单个
马更些河 河流面积	数字+单位	单个
马更些河 别称	其他	单个
马更些河 发源地	其他	句子
马更些河 流经地区	其他	多个
马更些河 英文名称	其他	多个
马更些河 所属水系	其他	单个
和田河 地理位置	其他	单个
和田河 平均流量	数字+单位	单个
和田河 主要支流	百科实体	多个
和田河 中文名称	其他	单个
和田河 流域面积	数字+单位	单个
和田河 河长	数字+单位	单个
和田河 河流面积	数字+单位	单个
和田河 别称	其他	单个
和田河 流经地区	其他	多个
和田河 英文名称	其他	多个
和田河 所属水系	其他	单个
密苏里河 流域面积	数字+单位	单个
密苏里河 别称	其他	单个
密苏里河 外文名	其他	多个
密苏里河 流经地区	其他	多个
哥伦比亚河 地理位置	其他	单个
哥伦比亚河 主要支流	百科实体	多个
哥伦比亚河 中文名称	其他	单个
哥伦比亚河 河长	数字+单位	单个
哥伦比亚河 河流面积	数字+单位	单个
哥伦比亚河 别称	其他	单个
哥伦比亚河 发源地	其他	句子
哥伦比亚河 流经地区	其他	多个
哥伦比亚河 英文名称	其他	多个
哥伦比亚河 所属水系	其他	单个
易北河 地理位置	其他	单个
易北河 流域面积	数字+单位	单个
易北河 外文名	其他	多个
穆尔加布河 主要支流	百科实体	多个
穆尔加布河 流域面积	数字+单位	单个
穆尔加布河 河长	数字+单位	单个
穆尔加布河 别称	其他	单个
穆尔加布河 外文名	其他	多个
穆尔加布河 所属水系	其他	单个
维斯瓦河 平均流量	数字+单位	单个
维斯瓦河 主要支流	百科实体	多个
维斯瓦河 流域面积	数字+单位	单个
维斯瓦河 河长	数字+单位	单个
维斯瓦河 河流面积	数字+单位	单个
维斯瓦河 别称	其他	单个
维斯瓦河 发源地	其他	句子
维斯瓦河 流经地区	其他	多个
维斯瓦河 英文名称	其他	多个
维斯瓦河 所属水系	其他	单个
卢瓦尔河 地理位置	其他	单个
卢瓦尔河 平均流量	数字+单位	单个
卢瓦尔河 流域面积	数字+单位	单个
卢瓦尔河 外文名	其他	多个
卢瓦尔河 所属水系	其他	单个
鸭绿江 地理位置	其他	单个
鸭绿江 主要支流	百科实体	多个
鸭绿江 中文名称	其他	单个
鸭绿江 河流面积	数字+单位	单个
鸭绿江 别称	其他	单个
鸭绿江 外文名	其他	多个
鸭绿江 流经地区	其他	多个
鸭绿江 英文名称	其他	多个
鸭绿江 所属水系	其他	单个
贾木纳河 平均流量	数字+单位	单个
贾木纳河 主要支流	百科实体	多个
贾木纳河 流域面积	数字+单位	单个
贾木纳河 河流面积	数字+单位	单个
贾木纳河 别称	其他	单个
贾木纳河 外文名	其他	多个
松花江 地理位置	其他	单个
松花江 平均流量	数字+单位	单个
松花江 主要支流	百科实体	多个
松花江 中文名称	其他	单个
松花江 河流面积	数字+单位	单个
松花江 别称	其他	单个
松花江 发源地	其他	句子
松花江 流经地区	其他	多个
松花江 英文名称	其他	多个
松花江 所属水系	其他	单个
育空河 主要支流	百科实体	多个
育空河 中文名称	其他	单个
育空河 河长	数字+单位	单个
育空河 河流面积	数字+单位	单个
育空河 别称	其他	单个
育空河 发源地	其他	句子
育空河 流经地区	其他	多个
育空河 英文名称	其他	多个
育空河 所属水系	其他	单个
贝努埃河 平均流量	数字+单位	单个
贝努埃河 主要支流	百科实体	多个
贝努埃河 流域面积	数字+单位	单个
贝努埃河 河流面积	数字+单位	单个
贝努埃河 别称	其他	单个
贝努埃河 外文名	其他	多个
贝努埃河 流经地区	其他	多个
贝努埃河 所属水系	其他	单个
茹鲁埃纳河 地理位置	其他	单个
茹鲁埃纳河 平均流量	数字+单位	单个
茹鲁埃纳河 主要支流	百科实体	多个
茹鲁埃纳河 中文名称	其他	单个
茹鲁埃纳河 流域面积	数字+单位	单个
茹鲁埃纳河 河长	数字+单位	单个
茹鲁埃纳河 河流面积	数字+单位	单个
茹鲁埃纳河 别称	其他	单个
茹鲁埃纳河 发源地	其他	句子
茹鲁埃纳河 流经地区	其他	多个
茹鲁埃纳河 英文名称	其他	多个
茹鲁埃纳河 所属水系	其他	单个
詹姆斯河 平均流量	数字+单位	单个
詹姆斯河 主要支流	百科实体	多个
詹姆斯河 中文名称	其他	单个
詹姆斯河 流域面积	数字+单位	单个
詹姆斯河 河长	数字+单位	单个
詹姆斯河 河流面积	数字+单位	单个
詹姆斯河 别称	其他	单个
詹姆斯河 发源地	其他	句子
詹姆斯河 流经地区	其他	多个
詹姆斯河 英文名称	其他	多个
詹姆斯河 所属水系	其他	单个
奎师那河 平均流量	数字+单位	单个
奎师那河 主要支流	百科实体	多个
奎师那河 流域面积	数字+单位	单个
奎师那河 河流面积	数字+单位	单个
奎师那河 发源地	其他	句子
奎师那河 外文名	其他	多个
奎师那河 流经地区	其他	多个
奎师那河 所属水系	其他	单个
浊水溪 地理位置	其他	单个
浊水溪 平均流量	数字+单位	单个
浊水溪 主要支流	百科实体	多个
浊水溪 中文名称	其他	单个
浊水溪 河长	数字+单位	单个
浊水溪 河流面积	数字+单位	单个
浊水溪 别称	其他	单个
浊水溪 发源地	其他	句子
浊水溪 流经地区	其他	多个
浊水溪 英文名称	其他	多个
浊水溪 所属水系	其他	单个
瓜波雷河 地理位置	其他	单个
瓜波雷河 平均流量	数字+单位	单个
瓜波雷河 主要支流	百科实体	多个
瓜波雷河 中文名称	其他	单个
瓜波雷河 流域面积	数字+单位	单个
瓜波雷河 河长	数字+单位	单个
瓜波雷河 河流面积	数字+单位	单个
瓜波雷河 别称	其他	单个
瓜波雷河 发源地	其他	句子
瓜波雷河 流经地区	其他	多个
瓜波雷河 英文名称	其他	多个
瓜波雷河 所属水系	其他	单个
北顿涅茨河 地理位置	其他	单个
北顿涅茨河 主要支流	百科实体	多个
北顿涅茨河 流域面积	数字+单位	单个
北顿涅茨河 别称	其他	单个
北顿涅茨河 外文名	其他	多个
纳尔逊河 主要支流	百科实体	多个
纳尔逊河 中文名称	其他	单个
纳尔逊河 河长	数字+单位	单个
纳尔逊河 河流面积	数字+单位	单个
纳尔逊河 别称	其他	单个
纳尔逊河 发源地	其他	句子
纳尔逊河 流经地区	其他	多个
纳尔逊河 英文名称	其他	多个
纳尔逊河 所属水系	其他	单个
马格达莱纳河 流域面积	数字+单位	单个
马格达莱纳河 别称	其他	单个
马格达莱纳河 外文名	其他	多个
马格达莱纳河 流经地区	其他	多个
马格达莱纳河 所属水系	其他	单个
皮科马约河 平均流量	数字+单位	单个
皮科马约河 主要支流	百科实体	多个
皮科马约河 流域面积	数字+单位	单个
皮科马约河 河长	数字+单位	单个
皮科马约河 河流面积	数字+单位	单个
皮科马约河 别称	其他	单个
皮科马约河 发源地	其他	句子
皮科马约河 流经地区	其他	多个
皮科马约河 英文名称	其他	多个
皮科马约河 所属水系	其他	单个
亚马逊河 主要支流	百科实体	多个
亚马逊河 河长	数字+单位	单个
亚马逊河 河流面积	数字+单位	单个
亚马逊河 别称	其他	单个
亚马逊河 发源地	其他	句子
亚马逊河 流经地区	其他	多个
亚马逊河 英文名称	其他	多个
亚马逊河 所属水系	其他	单个
通天河 流域面积	数字+单位	单个
通天河 外文名	其他	多个
通天河 英文名称	其他	多个
底格里斯河 流域面积	数字+单位	单个
底格里斯河 别称	其他	单个
底格里斯河 外文名	其他	多个
莱茵河 地理位置	其他	单个
莱茵河 主要支流	百科实体	多个
莱茵河 中文名称	其他	单个
莱茵河 河长	数字+单位	单个
莱茵河 河流面积	数字+单位	单个
莱茵河 别称	其他	单个
莱茵河 流经地区	其他	多个
莱茵河 英文名称	其他	多个
莱茵河 所属水系	其他	单个
珠江 地理位置	其他	单个
珠江 平均流量	数字+单位	单个
珠江 主要支流	百科实体	多个
珠江 中文名称	其他	单个
珠江 河长	数字+单位	单个
珠江 河流面积	数字+单位	单个
珠江 外文名	其他	多个
珠江 英文名称	其他	多个
宽果河 地理位置	其他	单个
宽果河 平均流量	数字+单位	单个
宽果河 流域面积	数字+单位	单个
宽果河 河长	数字+单位	单个
宽果河 河流面积	数字+单位	单个
宽果河 别称	其他	单个
宽果河 发源地	其他	句子
宽果河 外文名	其他	多个
宽果河 流经地区	其他	多个
宽果河 英文名称	其他	多个
宽果河 所属水系	其他	单个
玛代拉河 地理位置	其他	单个
玛代拉河 平均流量	数字+单位	单个
玛代拉河 主要支流	百科实体	多个
玛代拉河 流域面积	数字+单位	单个
玛代拉河 别称	其他	单个
玛代拉河 发源地	其他	句子
玛代拉河 外文名	其他	多个
玛代拉河 流经地区	其他	多个
玛代拉河 英文名称	其他	多个
沅江 平均流量	数字+单位	单个
沅江 主要支流	百科实体	多个
沅江 流域面积	数字+单位	单个
沅江 河长	数字+单位	单个
沅江 河流面积	数字+单位	单个
沅江 别称	其他	单个
沅江 发源地	其他	句子
沅江 流经地区	其他	多个
沅江 英文名称	其他	多个
沅江 所属水系	其他	单个
鉴江 平均流量	数字+单位	单个
鉴江 中文名称	其他	单个
鉴江 河流面积	数字+单位	单个
鉴江 别称	其他	单个
鉴江 发源地	其他	句子
鉴江 英文名称	其他	多个
黄河 流域面积	数字+单位	单个
黄河 外文名	其他	多个
沂河 地理位置	其他	单个
沂河 流域面积	数字+单位	单个
沂河 流经地区	其他	多个
沂河 英文名称	其他	多个
滦河 平均流量	数字+单位	单个
滦河 主要支流	百科实体	多个
滦河 流域面积	数字+单位	单个
滦河 外文名	其他	多个
滦河 英文名称	其他	多个
怒江 地理位置	其他	单个
怒江 平均流量	数字+单位	单个
怒江 主要支流	百科实体	多个
怒江 中文名称	其他	单个
怒江 河流面积	数字+单位	单个
怒江 发源地	其他	句子
怒江 流经地区	其他	多个
怒江 英文名称	其他	多个
怒江 所属水系	其他	单个
岷江 流域面积	数字+单位	单个
岷江 外文名	其他	多个
岷江 英文名称	其他	多个
澜沧江 流域面积	数字+单位	单个
澜沧江 外文名	其他	多个
梅克纳河 平均流量	数字+单位	单个
梅克纳河 主要支流	百科实体	多个
梅克纳河 流域面积	数字+单位	单个
梅克纳河 河流面积	数字+单位	单个
梅克纳河 别称	其他	单个
梅克纳河 外文名	其他	多个
北德维纳河 地理位置	其他	单个
北德维纳河 主要支流	百科实体	多个
北德维纳河 中文名称	其他	单个
北德维纳河 河长	数字+单位	单个
北德维纳河 河流面积	数字+单位	单个
北德维纳河 别称	其他	单个
北德维纳河 发源地	其他	句子
北德维纳河 流经地区	其他	多个
北德维纳河 英文名称	其他	多个
北德维纳河 所属水系	其他	单个
黄石河 流域面积	数字+单位	单个
黄石河 别称	其他	单个
黄石河 外文名	其他	多个
阿拉伯河 地理位置	其他	单个
阿拉伯河 主要支流	百科实体	多个
阿拉伯河 中文名称	其他	单个
阿拉伯河 流域面积	数字+单位	单个
阿拉伯河 河长	数字+单位	单个
阿拉伯河 河流面积	数字+单位	单个
阿拉伯河 别称	其他	单个
阿拉伯河 发源地	其他	句子
阿拉伯河 流经地区	其他	多个
阿拉伯河 英文名称	其他	多个
阿拉伯河 所属水系	其他	单个
辽河 平均流量	数字+单位	单个
辽河 流域面积	数字+单位	单个
辽河 别称	其他	单个
辽河 外文名	其他	多个
辽河 英文名称	其他	多个
淮河 地理位置	其他	单个
淮河 平均流量	数字+单位	单个
淮河 中文名称	其他	单个
淮河 河长	数字+单位	单个
淮河 河流面积	数字+单位	单个
淮河 别称	其他	单个
淮河 发源地	其他	句子
淮河 流经地区	其他	多个
淮河 英文名称	其他	多个
淮河 所属水系	其他	单个
喷赤河 地理位置	其他	单个
喷赤河 平均流量	数字+单位	单个
喷赤河 主要支流	百科实体	多个
喷赤河 中文名称	其他	单个
喷赤河 流域面积	数字+单位	单个
喷赤河 河长	数字+单位	单个
喷赤河 河流面积	数字+单位	单个
喷赤河 别称	其他	单个
喷赤河 发源地	其他	句子
喷赤河 流经地区	其他	多个
喷赤河 英文名称	其他	多个
喷赤河 所属水系	其他	单个
贝尔梅霍河 平均流量	数字+单位	单个
贝尔梅霍河 主要支流	百科实体	多个
贝尔梅霍河 流域面积	数字+单位	单个
贝尔梅霍河 河长	数字+单位	单个
贝尔梅霍河 河流面积	数字+单位	单个
贝尔梅霍河 别称	其他	单个
贝尔梅霍河 发源地	其他	句子
贝尔梅霍河 外文名	其他	多个
贝尔梅霍河 流经地区	其他	多个
贝尔梅霍河 英文名称	其他	多个
贝尔梅霍河 所属水系	其他	单个
捷詹河 主要支流	百科实体	多个
捷詹河 流域面积	数字+单位	单个
捷詹河 外文名	其他	多个
捷詹河 所属水系	其他	单个
维切格达河 流域面积	数字+单位	单个
维切格达河 外文名	其他	多个
维切格达河 流经地区	其他	多个
嫩江 平均流量	数字+单位	单个
嫩江 主要支流	百科实体	多个
嫩江 流域面积	数字+单位	单个
嫩江 河长	数字+单位	单个
嫩江 河流面积	数字+单位	单个
嫩江 别称	其他	单个
嫩江 发源地	其他	句子
嫩江 外文名	其他	多个
嫩江 流经地区	其他	多个
嫩江 英文名称	其他	多个
嫩江 所属水系	其他	单个
托坎廷斯河 地理位置	其他	单个
托坎廷斯河 平均流量	数字+单位	单个
托坎廷斯河 主要支流	百科实体	多个
托坎廷斯河 流域面积	数字+单位	单个
托坎廷斯河 河流面积	数字+单位	单个
托坎廷斯河 别称	其他	单个
托坎廷斯河 发源地	其他	句子
托坎廷斯河 外文名	其他	多个
托坎廷斯河 流经地区	其他	多个
托坎廷斯河 所属水系	其他	单个
拉普拉塔河 主要支流	百科实体	多个
拉普拉塔河 河长	数字+单位	单个
拉普拉塔河 河流面积	数字+单位	单个
拉普拉塔河 别称	其他	单个
拉普拉塔河 发源地	其他	句子
拉普拉塔河 流经地区	其他	多个
拉普拉塔河 英文名称	其他	多个
拉普拉塔河 所属水系	其他	单个
芬利河 地理位置	其他	单个
芬利河 平均流量	数字+单位	单个
芬利河 主要支流	百科实体	多个
芬利河 中文名称	其他	单个
芬利河 流域面积	数字+单位	单个
芬利河 河长	数字+单位	单个
芬利河 河流面积	数字+单位	单个
芬利河 别称	其他	单个
芬利河 发源地	其他	句子
芬利河 流经地区	其他	多个
芬利河 英文名称	其他	多个
芬利河 所属水系	其他	单个
普图马约河 地理位置	其他	单个
普图马约河 平均流量	数字+单位	单个
普图马约河 主要支流	百科实体	多个
普图马约河 中文名称	其他	单个
普图马约河 流域面积	数字+单位	单个
普图马约河 河长	数字+单位	单个
普图马约河 河流面积	数字+单位	单个
普图马约河 别称	其他	单个
普图马约河 发源地	其他	句子
普图马约河 流经地区	其他	多个
普图马约河 英文名称	其他	多个
普图马约河 所属水系	其他	单个
普拉特河 地理位置	其他	单个
普拉特河 平均流量	数字+单位	单个
普拉特河 主要支流	百科实体	多个
普拉特河 中文名称	其他	单个
普拉特河 流域面积	数字+单位	单个
普拉特河 河长	数字+单位	单个
普拉特河 河流面积	数字+单位	单个
普拉特河 别称	其他	单个
普拉特河 发源地	其他	句子
普拉特河 流经地区	其他	多个
普拉特河 英文名称	其他	多个
普拉特河 所属水系	其他	单个
勒拿河 地理位置	其他	单个
勒拿河 主要支流	百科实体	多个
勒拿河 中文名称	其他	单个
勒拿河 河长	数字+单位	单个
勒拿河 河流面积	数字+单位	单个
勒拿河 别称	其他	单个
勒拿河 发源地	其他	句子
勒拿河 流经地区	其他	多个
勒拿河 英文名称	其他	多个
勒拿河 所属水系	其他	单个
达令河 流域面积	数字+单位	单个
达令河 别称	其他	单个
达令河 外文名	其他	多个
红岩河 平均流量	数字+单位	单个
红岩河 主要支流	百科实体	多个
红岩河 中文名称	其他	单个
红岩河 流域面积	数字+单位	单个
红岩河 河长	数字+单位	单个
红岩河 河流面积	数字+单位	单个
红岩河 别称	其他	单个
红岩河 发源地	其他	句子
红岩河 外文名	其他	多个
红岩河 流经地区	其他	多个
红岩河 英文名称	其他	多个
红岩河 所属水系	其他	单个
格林河 平均流量	数字+单位	单个
格林河 主要支流	百科实体	多个
格林河 流域面积	数字+单位	单个
格林河 河长	数字+单位	单个
格林河 河流面积	数字+单位	单个
格林河 别称	其他	单个
格林河 发源地	其他	句子
格林河 流经地区	其他	多个
格林河 英文名称	其他	多个
格林河 所属水系	其他	单个
伊德尔河 地理位置	其他	单个
伊德尔河 平均流量	数字+单位	单个
伊德尔河 主要支流	百科实体	多个
伊德尔河 中文名称	其他	单个
伊德尔河 流域面积	数字+单位	单个
伊德尔河 河长	数字+单位	单个
伊德尔河 河流面积	数字+单位	单个
伊德尔河 别称	其他	单个
伊德尔河 发源地	其他	句子
伊德尔河 流经地区	其他	多个
伊德尔河 英文名称	其他	多个
伊德尔河 所属水系	其他	单个
恒河 流域面积	数字+单位	单个
恒河 外文名	其他	多个
底特律河 平均流量	数字+单位	单个
底特律河 主要支流	百科实体	多个
底特律河 中文名称	其他	单个
底特律河 流域面积	数字+单位	单个
底特律河 河长	数字+单位	单个
底特律河 河流面积	数字+单位	单个
底特律河 别称	其他	单个
底特律河 发源地	其他	句子
底特律河 流经地区	其他	多个
底特律河 英文名称	其他	多个
底特律河 所属水系	其他	单个
茹鲁阿河 地理位置	其他	单个
茹鲁阿河 平均流量	数字+单位	单个
茹鲁阿河 主要支流	百科实体	多个
茹鲁阿河 中文名称	其他	单个
茹鲁阿河 河长	数字+单位	单个
茹鲁阿河 河流面积	数字+单位	单个
茹鲁阿河 别称	其他	单个
茹鲁阿河 发源地	其他	句子
茹鲁阿河 流经地区	其他	多个
茹鲁阿河 英文名称	其他	多个
茹鲁阿河 所属水系	其他	单个
奥廖克马河 主要支流	百科实体	多个
奥廖克马河 河流面积	数字+单位	单个
奥廖克马河 别称	其他	单个
奥廖克马河 外文名	其他	多个
奥廖克马河 所属水系	其他	单个
巴拉那河 主要支流	百科实体	多个
巴拉那河 河长	数字+单位	单个
巴拉那河 河流面积	数字+单位	单个
巴拉那河 别称	其他	单个
巴拉那河 发源地	其他	句子
巴拉那河 流经地区	其他	多个
巴拉那河 英文名称	其他	多个
巴拉那河 所属水系	其他	单个
绥芬河 平均流量	数字+单位	单个
绥芬河 主要支流	百科实体	多个
绥芬河 流域面积	数字+单位	单个
绥芬河 河长	数字+单位	单个
绥芬河 河流面积	数字+单位	单个
绥芬河 别称	其他	单个
绥芬河 发源地	其他	句子
绥芬河 流经地区	其他	多个
绥芬河 英文名称	其他	多个
绥芬河 所属水系	其他	单个
萨斯喀彻温河 地理位置	其他	单个
萨斯喀彻温河 平均流量	数字+单位	单个
萨斯喀彻温河 主要支流	百科实体	多个
萨斯喀彻温河 中文名称	其他	单个
萨斯喀彻温河 河长	数字+单位	单个
萨斯喀彻温河 河流面积	数字+单位	单个
萨斯喀彻温河 别称	其他	单个
萨斯喀彻温河 流经地区	其他	多个
萨斯喀彻温河 英文名称	其他	多个
萨斯喀彻温河 所属水系	其他	单个
柳江 地理位置	其他	单个
柳江 平均流量	数字+单位	单个
柳江 中文名称	其他	单个
柳江 河流面积	数字+单位	单个
柳江 别称	其他	单个
柳江 外文名	其他	多个
柳江 英文名称	其他	多个
乌苏里江 地理位置	其他	单个
乌苏里江 平均流量	数字+单位	单个
乌苏里江 主要支流	百科实体	多个
乌苏里江 中文名称	其他	单个
乌苏里江 河长	数字+单位	单个
乌苏里江 河流面积	数字+单位	单个
乌苏里江 别称	其他	单个
乌苏里江 发源地	其他	句子
乌苏里江 外文名	其他	多个
乌苏里江 流经地区	其他	多个
乌苏里江 英文名称	其他	多个
乌苏里江 所属水系	其他	单个
锡马龙河 地理位置	其他	单个
锡马龙河 平均流量	数字+单位	单个
锡马龙河 流域面积	数字+单位	单个
锡马龙河 河流面积	数字+单位	单个
锡马龙河 别称	其他	单个
锡马龙河 发源地	其他	句子
锡马龙河 外文名	其他	多个
锡马龙河 所属水系	其他	单个
哥达瓦里河 平均流量	数字+单位	单个
哥达瓦里河 主要支流	百科实体	多个
哥达瓦里河 中文名称	其他	单个
哥达瓦里河 流域面积	数字+单位	单个
哥达瓦里河 河长	数字+单位	单个
哥达瓦里河 河流面积	数字+单位	单个
哥达瓦里河 别称	其他	单个
哥达瓦里河 发源地	其他	句子
哥达瓦里河 流经地区	其他	多个
哥达瓦里河 英文名称	其他	多个
哥达瓦里河 所属水系	其他	单个
色楞格河 平均流量	数字+单位	单个
色楞格河 主要支流	百科实体	多个
色楞格河 流域面积	数字+单位	单个
色楞格河 河长	数字+单位	单个
色楞格河 河流面积	数字+单位	单个
色楞格河 别称	其他	单个
色楞格河 发源地	其他	句子
色楞格河 流经地区	其他	多个
色楞格河 英文名称	其他	多个
色楞格河 所属水系	其他	单个
阿萨巴斯卡河 流域面积	数字+单位	单个
阿萨巴斯卡河 别称	其他	单个
阿萨巴斯卡河 外文名	其他	多个
乌拉尔河 平均流量	数字+单位	单个
乌拉尔河 河流面积	数字+单位	单个
乌拉尔河 外文名	其他	多个
乌拉尔河 流经地区	其他	多个
乌拉尔河 所属水系	其他	单个
穆拉特河 平均流量	数字+单位	单个
穆拉特河 主要支流	百科实体	多个
穆拉特河 流域面积	数字+单位	单个
穆拉特河 河长	数字+单位	单个
穆拉特河 河流面积	数字+单位	单个
穆拉特河 别称	其他	单个
穆拉特河 外文名	其他	多个
穆拉特河 流经地区	其他	多个
穆拉特河 所属水系	其他	单个
奥卡河 地理位置	其他	单个
奥卡河 平均流量	数字+单位	单个
奥卡河 主要支流	百科实体	多个
奥卡河 中文名称	其他	单个
奥卡河 河长	数字+单位	单个
奥卡河 河流面积	数字+单位	单个
奥卡河 别称	其他	单个
奥卡河 流经地区	其他	多个
奥卡河 英文名称	其他	多个
奥卡河 所属水系	其他	单个
开赛河 平均流量	数字+单位	单个
开赛河 主要支流	百科实体	多个
开赛河 流域面积	数字+单位	单个
开赛河 河长	数字+单位	单个
开赛河 河流面积	数字+单位	单个
开赛河 别称	其他	单个
开赛河 发源地	其他	句子
开赛河 流经地区	其他	多个
开赛河 英文名称	其他	多个
开赛河 所属水系	其他	单个
卡普阿斯河 流域面积	数字+单位	单个
卡普阿斯河 别称	其他	单个
卡普阿斯河 外文名	其他	多个
北萨斯喀彻温河 流域面积	数字+单位	单个
北萨斯喀彻温河 别称	其他	单个
北萨斯喀彻温河 外文名	其他	多个
北萨斯喀彻温河 流经地区	其他	多个
北萨斯喀彻温河 英文名称	其他	多个
长江 地理位置	其他	单个
长江 平均流量	数字+单位	单个
长江 中文名称	其他	单个
长江 河流面积	数字+单位	单个
长江 别称	其他	单个
长江 英文名称	其他	多个
圣弗朗西斯科河 地理位置	其他	单个
圣弗朗西斯科河 平均流量	数字+单位	单个
圣弗朗西斯科河 主要支流	百科实体	多个
圣弗朗西斯科河 中文名称	其他	单个
圣弗朗西斯科河 流域面积	数字+单位	单个
圣弗朗西斯科河 河流面积	数字+单位	单个
圣弗朗西斯科河 别称	其他	单个
圣弗朗西斯科河 发源地	其他	句子
圣弗朗西斯科河 流经地区	其他	多个
圣弗朗西斯科河 英文名称	其他	多个
圣弗朗西斯科河 所属水系	其他	单个
塔里木河 平均流量	数字+单位	单个
塔里木河 主要支流	百科实体	多个
塔里木河 流域面积	数字+单位	单个
塔里木河 河流面积	数字+单位	单个
塔里木河 别称	其他	单个
塔里木河 发源地	其他	句子
塔里木河 流经地区	其他	多个
塔里木河 英文名称	其他	多个
塔里木河 所属水系	其他	单个
黑海 地理位置	其他	单个
黑海 平均流量	数字+单位	单个
黑海 主要支流	百科实体	多个
黑海 中文名称	其他	单个
黑海 流域面积	数字+单位	单个
黑海 河长	数字+单位	单个
黑海 河流面积	数字+单位	单个
黑海 别称	其他	单个
黑海 发源地	其他	句子
黑海 流经地区	其他	多个
黑海 英文名称	其他	多个
黑海 所属水系	其他	单个
桑库鲁河 地理位置	其他	单个
桑库鲁河 平均流量	数字+单位	单个
桑库鲁河 主要支流	百科实体	多个
桑库鲁河 中文名称	其他	单个
桑库鲁河 流域面积	数字+单位	单个
桑库鲁河 河长	数字+单位	单个
桑库鲁河 河流面积	数字+单位	单个
桑库鲁河 别称	其他	单个
桑库鲁河 英文名称	其他	多个
桑库鲁河 所属水系	其他	单个
伯朝拉河 地理位置	其他	单个
伯朝拉河 平均流量	数字+单位	单个
伯朝拉河 主要支流	百科实体	多个
伯朝拉河 中文名称	其他	单个
伯朝拉河 河流面积	数字+单位	单个
伯朝拉河 别称	其他	单个
伯朝拉河 流经地区	其他	多个
伯朝拉河 英文名称	其他	多个
伯朝拉河 所属水系	其他	单个
希雷河 平均流量	数字+单位	单个
希雷河 主要支流	百科实体	多个
希雷河 流域面积	数字+单位	单个
希雷河 别称	其他	单个
希雷河 外文名	其他	多个
渥太华河 地理位置	其他	单个
渥太华河 平均流量	数字+单位	单个
渥太华河 主要支流	百科实体	多个
渥太华河 中文名称	其他	单个
渥太华河 流域面积	数字+单位	单个
渥太华河 河长	数字+单位	单个
渥太华河 河流面积	数字+单位	单个
渥太华河 别称	其他	单个
渥太华河 发源地	其他	句子
渥太华河 流经地区	其他	多个
渥太华河 英文名称	其他	多个
渥太华河 所属水系	其他	单个
钦敦江 平均流量	数字+单位	单个
钦敦江 主要支流	百科实体	多个
钦敦江 中文名称	其他	单个
钦敦江 流域面积	数字+单位	单个
钦敦江 河长	数字+单位	单个
钦敦江 河流面积	数字+单位	单个
钦敦江 别称	其他	单个
钦敦江 发源地	其他	句子
钦敦江 外文名	其他	多个
钦敦江 流经地区	其他	多个
钦敦江 英文名称	其他	多个
钦敦江 所属水系	其他	单个
田纳西河 地理位置	其他	单个
田纳西河 平均流量	数字+单位	单个
田纳西河 主要支流	百科实体	多个
田纳西河 中文名称	其他	单个
田纳西河 河长	数字+单位	单个
田纳西河 河流面积	数字+单位	单个
田纳西河 别称	其他	单个
田纳西河 发源地	其他	句子
田纳西河 流经地区	其他	多个
田纳西河 英文名称	其他	多个
田纳西河 所属水系	其他	单个
塞内加尔河 地理位置	其他	单个
塞内加尔河 主要支流	百科实体	多个
塞内加尔河 中文名称	其他	单个
塞内加尔河 河长	数字+单位	单个
塞内加尔河 河流面积	数字+单位	单个
塞内加尔河 别称	其他	单个
塞内加尔河 发源地	其他	句子
塞内加尔河 流经地区	其他	多个
塞内加尔河 英文名称	其他	多个
塞内加尔河 所属水系	其他	单个
伏尔加河 流域面积	数字+单位	单个
伏尔加河 外文名	其他	多个
阿肯色河 平均流量	数字+单位	单个
阿肯色河 主要支流	百科实体	多个
阿肯色河 流域面积	数字+单位	单个
阿肯色河 别称	其他	单个
阿肯色河 外文名	其他	多个
卡盖拉河 地理位置	其他	单个
卡盖拉河 平均流量	数字+单位	单个
卡盖拉河 主要支流	百科实体	多个
卡盖拉河 中文名称	其他	单个
卡盖拉河 流域面积	数字+单位	单个
卡盖拉河 河长	数字+单位	单个
卡盖拉河 河流面积	数字+单位	单个
卡盖拉河 发源地	其他	句子
卡盖拉河 流经地区	其他	多个
卡盖拉河 英文名称	其他	多个
卡盖拉河 所属水系	其他	单个
乌拉圭河 平均流量	数字+单位	单个
乌拉圭河 主要支流	百科实体	多个
乌拉圭河 中文名称	其他	单个
乌拉圭河 河长	数字+单位	单个
乌拉圭河 河流面积	数字+单位	单个
乌拉圭河 别称	其他	单个
乌拉圭河 流经地区	其他	多个
乌拉圭河 英文名称	其他	多个
乌拉圭河 所属水系	其他	单个
博多河 地理位置	其他	单个
博多河 主要支流	百科实体	多个
博多河 中文名称	其他	单个
博多河 河长	数字+单位	单个
博多河 河流面积	数字+单位	单个
博多河 别称	其他	单个
博多河 英文名称	其他	多个
博多河 所属水系	其他	单个
别拉亚河 地理位置	其他	单个
别拉亚河 平均流量	数字+单位	单个
别拉亚河 主要支流	百科实体	多个
别拉亚河 中文名称	其他	单个
别拉亚河 流域面积	数字+单位	单个
别拉亚河 河长	数字+单位	单个
别拉亚河 河流面积	数字+单位	单个
别拉亚河 别称	其他	单个
别拉亚河 发源地	其他	句子
别拉亚河 流经地区	其他	多个
别拉亚河 英文名称	其他	多个
别拉亚河 所属水系	其他	单个
雅普拉河 地理位置	其他	单个
雅普拉河 平均流量	数字+单位	单个
雅普拉河 主要支流	百科实体	多个
雅普拉河 中文名称	其他	单个
雅普拉河 流域面积	数字+单位	单个
雅普拉河 河长	数字+单位	单个
雅普拉河 河流面积	数字+单位	单个
雅普拉河 别称	其他	单个
雅普拉河 流经地区	其他	多个
雅普拉河 英文名称	其他	多个
雅普拉河 所属水系	其他	单个
奥卡万戈河 平均流量	数字+单位	单个
奥卡万戈河 主要支流	百科实体	多个
奥卡万戈河 流域面积	数字+单位	单个
奥卡万戈河 河长	数字+单位	单个
奥卡万戈河 河流面积	数字+单位	单个
奥卡万戈河 别称	其他	单个
奥卡万戈河 发源地	其他	句子
奥卡万戈河 流经地区	其他	多个
奥卡万戈河 英文名称	其他	多个
奥卡万戈河 所属水系	其他	单个
汉水 地理位置	其他	单个
汉水 平均流量	数字+单位	单个
汉水 中文名称	其他	单个
汉水 河流面积	数字+单位	单个
汉水 外文名	其他	多个
汉水 英文名称	其他	多个
嘉陵江 地理位置	其他	单个
嘉陵江 平均流量	数字+单位	单个
嘉陵江 主要支流	百科实体	多个
嘉陵江 中文名称	其他	单个
嘉陵江 河长	数字+单位	单个
嘉陵江 河流面积	数字+单位	单个
嘉陵江 英文名称	其他	多个
巴拉圭河 地理位置	其他	单个
巴拉圭河 平均流量	数字+单位	单个
巴拉圭河 中文名称	其他	单个
巴拉圭河 河长	数字+单位	单个
巴拉圭河 河流面积	数字+单位	单个
巴拉圭河 别称	其他	单个
巴拉圭河 发源地	其他	句子
巴拉圭河 外文名	其他	多个
巴拉圭河 流经地区	其他	多个
巴拉圭河 英文名称	其他	多个
巴拉圭河 所属水系	其他	单个
湘江 地理位置	其他	单个
湘江 平均流量	数字+单位	单个
湘江 主要支流	百科实体	多个
湘江 中文名称	其他	单个
湘江 河流面积	数字+单位	单个
湘江 别称	其他	单个
湘江 外文名	其他	多个
湘江 英文名称	其他	多个
冈比亚河 地理位置	其他	单个
冈比亚河 平均流量	数字+单位	单个
冈比亚河 主要支流	百科实体	多个
冈比亚河 流域面积	数字+单位	单个
冈比亚河 别称	其他	单个
冈比亚河 外文名	其他	多个
冈比亚河 所属水系	其他	单个
弗莱河 流域面积	数字+单位	单个
弗莱河 外文名	其他	多个
南渡河 平均流量	数字+单位	单个
南渡河 中文名称	其他	单个
南渡河 河长	数字+单位	单个
南渡河 河流面积	数字+单位	单个
南渡河 外文名	其他	多个
南渡河 流经地区	其他	多个
南渡河 英文名称	其他	多个
格兰德河 地理位置	其他	单个
格兰德河 平均流量	数字+单位	单个
格兰德河 主要支流	百科实体	多个
格兰德河 中文名称	其他	单个
格兰德河 河长	数字+单位	单个
格兰德河 河流面积	数字+单位	单个
格兰德河 别称	其他	单个
格兰德河 发源地	其他	句子
格兰德河 流经地区	其他	多个
格兰德河 英文名称	其他	多个
格兰德河 所属水系	其他	单个
赫尔曼德河 平均流量	数字+单位	单个
赫尔曼德河 流域面积	数字+单位	单个
赫尔曼德河 外文名	其他	多个
赫尔曼德河 所属水系	其他	单个
特克斯河 地理位置	其他	单个
特克斯河 平均流量	数字+单位	单个
特克斯河 主要支流	百科实体	多个
特克斯河 流域面积	数字+单位	单个
特克斯河 发源地	其他	句子
特克斯河 外文名	其他	多个
特克斯河 流经地区	其他	多个
特克斯河 英文名称	其他	多个
特克斯河 所属水系	其他	单个
丘吉尔河 地理位置	其他	单个
丘吉尔河 平均流量	数字+单位	单个
丘吉尔河 主要支流	百科实体	多个
丘吉尔河 中文名称	其他	单个
丘吉尔河 河长	数字+单位	单个
丘吉尔河 河流面积	数字+单位	单个
丘吉尔河 别称	其他	单个
丘吉尔河 发源地	其他	句子
丘吉尔河 流经地区	其他	多个
丘吉尔河 英文名称	其他	多个
丘吉尔河 所属水系	其他	单个
阿普里马克河 地理位置	其他	单个
阿普里马克河 平均流量	数字+单位	单个
阿普里马克河 主要支流	百科实体	多个
阿普里马克河 中文名称	其他	单个
阿普里马克河 流域面积	数字+单位	单个
阿普里马克河 河长	数字+单位	单个
阿普里马克河 河流面积	数字+单位	单个
阿普里马克河 别称	其他	单个
阿普里马克河 发源地	其他	句子
阿普里马克河 流经地区	其他	多个
阿普里马克河 英文名称	其他	多个
阿普里马克河 所属水系	其他	单个
伏塔河 地理位置	其他	单个
伏塔河 平均流量	数字+单位	单个
伏塔河 主要支流	百科实体	多个
伏塔河 流域面积	数字+单位	单个
伏塔河 河长	数字+单位	单个
伏塔河 河流面积	数字+单位	单个
伏塔河 别称	其他	单个
伏塔河 流经地区	其他	多个
伏塔河 英文名称	其他	多个
伏塔河 所属水系	其他	单个
普鲁斯河 地理位置	其他	单个
普鲁斯河 主要支流	百科实体	多个
普鲁斯河 中文名称	其他	单个
普鲁斯河 河长	数字+单位	单个
普鲁斯河 河流面积	数字+单位	单个
普鲁斯河 别称	其他	单个
普鲁斯河 发源地	其他	句子
普鲁斯河 流经地区	其他	多个
普鲁斯河 英文名称	其他	多个
普鲁斯河 所属水系	其他	单个
喀什噶尔河 地理位置	其他	单个
喀什噶尔河 平均流量	数字+单位	单个
喀什噶尔河 主要支流	百科实体	多个
喀什噶尔河 中文名称	其他	单个
喀什噶尔河 流域面积	数字+单位	单个
喀什噶尔河 河长	数字+单位	单个
喀什噶尔河 河流面积	数字+单位	单个
喀什噶尔河 别称	其他	单个
喀什噶尔河 发源地	其他	句子
喀什噶尔河 外文名	其他	多个
喀什噶尔河 流经地区	其他	多个
喀什噶尔河 英文名称	其他	多个
喀什噶尔河 所属水系	其他	单个
图们江 流域面积	数字+单位	单个
图们江 外文名	其他	多个
图们江 英文名称	其他	多个
道加瓦河 流域面积	数字+单位	单个
道加瓦河 外文名	其他	多个
道加瓦河 英文名称	其他	多个
道加瓦河 所属水系	其他	单个
玛纳斯河 地理位置	其他	单个
玛纳斯河 平均流量	数字+单位	单个
玛纳斯河 主要支流	百科实体	多个
玛纳斯河 中文名称	其他	单个
玛纳斯河 流域面积	数字+单位	单个
玛纳斯河 河流面积	数字+单位	单个
玛纳斯河 别称	其他	单个
玛纳斯河 发源地	其他	句子
玛纳斯河 外文名	其他	多个
玛纳斯河 流经地区	其他	多个
玛纳斯河 英文名称	其他	多个
玛纳斯河 所属水系	其他	单个
雅鲁藏布江 流域面积	数字+单位	单个
雅鲁藏布江 外文名	其他	多个
塞皮克河 流域面积	数字+单位	单个
塞皮克河 别称	其他	单个
塞皮克河 外文名	其他	多个
格尔木河 平均流量	数字+单位	单个
格尔木河 主要支流	百科实体	多个
格尔木河 流域面积	数字+单位	单个
格尔木河 河流面积	数字+单位	单个
格尔木河 别称	其他	单个
格尔木河 发源地	其他	句子
格尔木河 外文名	其他	多个
格尔木河 流经地区	其他	多个
格尔木河 英文名称	其他	多个
格尔木河 所属水系	其他	单个
布拉索斯河 平均流量	数字+单位	单个
布拉索斯河 主要支流	百科实体	多个
布拉索斯河 流域面积	数字+单位	单个
布拉索斯河 别称	其他	单个
布拉索斯河 外文名	其他	多个
布拉索斯河 流经地区	其他	多个
布拉索斯河 所属水系	其他	单个
马拉尼翁河 地理位置	其他	单个
马拉尼翁河 平均流量	数字+单位	单个
马拉尼翁河 主要支流	百科实体	多个
马拉尼翁河 中文名称	其他	单个
马拉尼翁河 流域面积	数字+单位	单个
马拉尼翁河 河长	数字+单位	单个
马拉尼翁河 河流面积	数字+单位	单个
马拉尼翁河 别称	其他	单个
马拉尼翁河 发源地	其他	句子
马拉尼翁河 外文名	其他	多个
马拉尼翁河 流经地区	其他	多个
马拉尼翁河 英文名称	其他	多个
马拉尼翁河 所属水系	其他	单个
沱沱河 平均流量	数字+单位	单个
沱沱河 主要支流	百科实体	多个
沱沱河 流域面积	数字+单位	单个
沱沱河 河长	数字+单位	单个
沱沱河 外文名	其他	多个
象泉河 地理位置	其他	单个
象泉河 平均流量	数字+单位	单个
象泉河 主要支流	百科实体	多个
象泉河 中文名称	其他	单个
象泉河 河长	数字+单位	单个
象泉河 河流面积	数字+单位	单个
象泉河 别称	其他	单个
象泉河 流经地区	其他	多个
象泉河 英文名称	其他	多个
象泉河 所属水系	其他	单个
钱塘江 地理位置	其他	单个
钱塘江 主要支流	百科实体	多个
钱塘江 中文名称	其他	单个
钱塘江 河长	数字+单位	单个
钱塘江 河流面积	数字+单位	单个
钱塘江 别称	其他	单个
钱塘江 流经地区	其他	多个
钱塘江 英文名称	其他	多个
钱塘江 所属水系	其他	单个
大渡河 河流面积	数字+单位	单个
大渡河 外文名	其他	多个
大渡河 英文名称	其他	多个
瓦尔河 地理位置	其他	单个
瓦尔河 平均流量	数字+单位	单个
瓦尔河 主要支流	百科实体	多个
瓦尔河 中文名称	其他	单个
瓦尔河 流域面积	数字+单位	单个
瓦尔河 河长	数字+单位	单个
瓦尔河 河流面积	数字+单位	单个
瓦尔河 别称	其他	单个
瓦尔河 发源地	其他	句子
瓦尔河 流经地区	其他	多个
瓦尔河 英文名称	其他	多个
瓦尔河 所属水系	其他	单个
多瑙河 流域面积	数字+单位	单个
多瑙河 别称	其他	单个
多瑙河 外文名	其他	多个
洮河 流域面积	数字+单位	单个
洮河 外文名	其他	多个
雅砻江 平均流量	数字+单位	单个
雅砻江 中文名称	其他	单个
雅砻江 河流面积	数字+单位	单个
雅砻江 英文名称	其他	多个
赣江 地理位置	其他	单个
赣江 平均流量	数字+单位	单个
赣江 主要支流	百科实体	多个
赣江 中文名称	其他	单个
赣江 河流面积	数字+单位	单个
赣江 别称	其他	单个
赣江 流经地区	其他	多个
赣江 英文名称	其他	多个
赣江 所属水系	其他	单个
结雅河 流域面积	数字+单位	单个
结雅河 外文名	其他	多个
结雅河 英文名称	其他	多个
墨累河 流域面积	数字+单位	单个
墨累河 别称	其他	单个
墨累河 外文名	其他	多个
雷德河 地理位置	其他	单个
雷德河 平均流量	数字+单位	单个
雷德河 主要支流	百科实体	多个
雷德河 流域面积	数字+单位	单个
雷德河 别称	其他	单个
雷德河 外文名	其他	多个
雷德河 流经地区	其他	多个
雷德河 所属水系	其他	单个
橘河 地理位置	其他	单个
橘河 平均流量	数字+单位	单个
橘河 主要支流	百科实体	多个
橘河 中文名称	其他	单个
橘河 流域面积	数字+单位	单个
橘河 河长	数字+单位	单个
橘河 河流面积	数字+单位	单个
橘河 流经地区	其他	多个
橘河 英文名称	其他	多个
橘河 所属水系	其他	单个
托博尔河 平均流量	数字+单位	单个
托博尔河 主要支流	百科实体	多个
托博尔河 流域面积	数字+单位	单个
托博尔河 河长	数字+单位	单个
托博尔河 河流面积	数字+单位	单个
托博尔河 别称	其他	单个
托博尔河 发源地	其他	句子
托博尔河 流经地区	其他	多个
托博尔河 英文名称	其他	多个
托博尔河 所属水系	其他	单个
谦比西河 地理位置	其他	单个
谦比西河 平均流量	数字+单位	单个
谦比西河 主要支流	百科实体	多个
谦比西河 流域面积	数字+单位	单个
谦比西河 河流面积	数字+单位	单个
谦比西河 别称	其他	单个
谦比西河 发源地	其他	句子
谦比西河 外文名	其他	多个
谦比西河 所属水系	其他	单个
瓯江 平均流量	数字+单位	单个
瓯江 河流面积	数字+单位	单个
瓯江 外文名	其他	多个
瓯江 英文名称	其他	多个
幼发拉底河 主要支流	百科实体	多个
幼发拉底河 流域面积	数字+单位	单个
幼发拉底河 别称	其他	单个
幼发拉底河 外文名	其他	多个
安加拉河 地理位置	其他	单个
安加拉河 平均流量	数字+单位	单个
安加拉河 主要支流	百科实体	多个
安加拉河 中文名称	其他	单个
安加拉河 河长	数字+单位	单个
安加拉河 河流面积	数字+单位	单个
安加拉河 别称	其他	单个
安加拉河 发源地	其他	句子
安加拉河 流经地区	其他	多个
安加拉河 英文名称	其他	多个
安加拉河 所属水系	其他	单个
柯柏河 地理位置	其他	单个
柯柏河 平均流量	数字+单位	单个
柯柏河 中文名称	其他	单个
柯柏河 流域面积	数字+单位	单个
柯柏河 河长	数字+单位	单个
柯柏河 河流面积	数字+单位	单个
柯柏河 别称	其他	单个
柯柏河 英文名称	其他	多个
柯柏河 所属水系	其他	单个
澧水 地理位置	其他	单个
澧水 平均流量	数字+单位	单个
澧水 主要支流	百科实体	多个
澧水 中文名称	其他	单个
澧水 河流面积	数字+单位	单个
澧水 发源地	其他	句子
澧水 流经地区	其他	多个
澧水 英文名称	其他	多个
资水 地理位置	其他	单个
资水 平均流量	数字+单位	单个
资水 主要支流	百科实体	多个
资水 中文名称	其他	单个
资水 河流面积	数字+单位	单个
资水 别称	其他	单个
资水 外文名	其他	多个
资水 流经地区	其他	多个
资水 英文名称	其他	多个
弗雷泽河 地理位置	其他	单个
弗雷泽河 平均流量	数字+单位	单个
弗雷泽河 主要支流	百科实体	多个
弗雷泽河 中文名称	其他	单个
弗雷泽河 流域面积	数字+单位	单个
弗雷泽河 河长	数字+单位	单个
弗雷泽河 河流面积	数字+单位	单个
弗雷泽河 别称	其他	单个
弗雷泽河 发源地	其他	句子
弗雷泽河 流经地区	其他	多个
弗雷泽河 英文名称	其他	多个
弗雷泽河 所属水系	其他	单个
额尔齐斯河 地理位置	其他	单个
额尔齐斯河 平均流量	数字+单位	单个
额尔齐斯河 主要支流	百科实体	多个
额尔齐斯河 中文名称	其他	单个
额尔齐斯河 河流面积	数字+单位	单个
额尔齐斯河 别称	其他	单个
额尔齐斯河 流经地区	其他	多个
额尔齐斯河 英文名称	其他	多个
额尔齐斯河 所属水系	其他	单个
阿拉瓜亚河 平均流量	数字+单位	单个
阿拉瓜亚河 主要支流	百科实体	多个
阿拉瓜亚河 流域面积	数字+单位	单个
阿拉瓜亚河 河长	数字+单位	单个
阿拉瓜亚河 河流面积	数字+单位	单个
阿拉瓜亚河 别称	其他	单个
阿拉瓜亚河 发源地	其他	句子
阿拉瓜亚河 流经地区	其他	多个
阿拉瓜亚河 英文名称	其他	多个
阿拉瓜亚河 所属水系	其他	单个
刚果河 流域面积	数字+单位	单个
刚果河 外文名	其他	多个
额尔古纳河 平均流量	数字+单位	单个
额尔古纳河 流域面积	数字+单位	单个
额尔古纳河 外文名	其他	多个
额尔古纳河 英文名称	其他	多个
内格罗河 地理位置	其他	单个
内格罗河 平均流量	数字+单位	单个
内格罗河 主要支流	百科实体	多个
内格罗河 中文名称	其他	单个
内格罗河 流域面积	数字+单位	单个
内格罗河 河长	数字+单位	单个
内格罗河 河流面积	数字+单位	单个
内格罗河 别称	其他	单个
内格罗河 发源地	其他	句子
内格罗河 流经地区	其他	多个
内格罗河 英文名称	其他	多个
内格罗河 所属水系	其他	单个
元江 地理位置	其他	单个
元江 平均流量	数字+单位	单个
元江 主要支流	百科实体	多个
元江 中文名称	其他	单个
元江 河长	数字+单位	单个
元江 河流面积	数字+单位	单个
元江 别称	其他	单个
元江 发源地	其他	句子
元江 流经地区	其他	多个
元江 英文名称	其他	多个
印度河 平均流量	数字+单位	单个
印度河 主要支流	百科实体	多个
印度河 中文名称	其他	单个
印度河 河流面积	数字+单位	单个
印度河 别称	其他	单个
印度河 流经地区	其他	多个
印度河 英文名称	其他	多个
印度河 所属水系	其他	单个
希拉河 平均流量	数字+单位	单个
希拉河 流域面积	数字+单位	单个
希拉河 别称	其他	单个
希拉河 外文名	其他	多个
希拉河 流经地区	其他	多个
希拉河 所属水系	其他	单个
因迪吉尔卡河 流域面积	数字+单位	单个
因迪吉尔卡河 别称	其他	单个
因迪吉尔卡河 外文名	其他	多个
乌卡亚利河 地理位置	其他	单个
乌卡亚利河 平均流量	数字+单位	单个
乌卡亚利河 中文名称	其他	单个
乌卡亚利河 流域面积	数字+单位	单个
乌卡亚利河 河长	数字+单位	单个
乌卡亚利河 河流面积	数字+单位	单个
乌卡亚利河 别称	其他	单个
乌卡亚利河 流经地区	其他	多个
乌卡亚利河 英文名称	其他	多个
乌卡亚利河 所属水系	其他	单个
尼日尔河 地理位置	其他	单个
尼日尔河 平均流量	数字+单位	单个
尼日尔河 主要支流	百科实体	多个
尼日尔河 中文名称	其他	单个
尼日尔河 河长	数字+单位	单个
尼日尔河 河流面积	数字+单位	单个
尼日尔河 别称	其他	单个
尼日尔河 流经地区	其他	多个
尼日尔河 英文名称	其他	多个
尼日尔河 所属水系	其他	单个
韩江 地理位置	其他	单个
韩江 平均流量	数字+单位	单个
韩江 主要支流	百科实体	多个
韩江 中文名称	其他	单个
韩江 河流面积	数字+单位	单个
韩江 别称	其他	单个
韩江 发源地	其他	句子
韩江 流经地区	其他	多个
韩江 英文名称	其他	多个
韩江 所属水系	其他	单个
马德雷德迪奥斯河 平均流量	数字+单位	单个
马德雷德迪奥斯河 流域面积	数字+单位	单个
马德雷德迪奥斯河 河流面积	数字+单位	单个
马德雷德迪奥斯河 别称	其他	单个
马德雷德迪奥斯河 外文名	其他	多个
马德雷德迪奥斯河 流经地区	其他	多个
车尔臣河 地理位置	其他	单个
车尔臣河 平均流量	数字+单位	单个
车尔臣河 主要支流	百科实体	多个
车尔臣河 中文名称	其他	单个
车尔臣河 流域面积	数字+单位	单个
车尔臣河 河长	数字+单位	单个
车尔臣河 河流面积	数字+单位	单个
车尔臣河 别称	其他	单个
车尔臣河 发源地	其他	句子
车尔臣河 流经地区	其他	多个
车尔臣河 英文名称	其他	多个
车尔臣河 所属水系	其他	单个
下淡水溪 地理位置	其他	单个
下淡水溪 平均流量	数字+单位	单个
下淡水溪 主要支流	百科实体	多个
下淡水溪 中文名称	其他	单个
下淡水溪 河长	数字+单位	单个
下淡水溪 河流面积	数字+单位	单个
下淡水溪 别称	其他	单个
下淡水溪 发源地	其他	句子
下淡水溪 外文名	其他	多个
下淡水溪 流经地区	其他	多个
下淡水溪 英文名称	其他	多个
下淡水溪 所属水系	其他	单个
叶尔羌河 平均流量	数字+单位	单个
叶尔羌河 主要支流	百科实体	多个
叶尔羌河 流域面积	数字+单位	单个
叶尔羌河 河长	数字+单位	单个
叶尔羌河 河流面积	数字+单位	单个
叶尔羌河 别称	其他	单个
叶尔羌河 发源地	其他	句子
叶尔羌河 流经地区	其他	多个
叶尔羌河 所属水系	其他	单个
第聂伯河 地理位置	其他	单个
第聂伯河 主要支流	百科实体	多个
第聂伯河 中文名称	其他	单个
第聂伯河 河长	数字+单位	单个
第聂伯河 河流面积	数字+单位	单个
第聂伯河 别称	其他	单个
第聂伯河 发源地	其他	句子
第聂伯河 流经地区	其他	多个
第聂伯河 英文名称	其他	多个
第聂伯河 所属水系	其他	单个
萨特莱杰河 地理位置	其他	单个
萨特莱杰河 平均流量	数字+单位	单个
萨特莱杰河 主要支流	百科实体	多个
萨特莱杰河 流域面积	数字+单位	单个
萨特莱杰河 河长	数字+单位	单个
萨特莱杰河 外文名	其他	多个
萨特莱杰河 流经地区	其他	多个
乌江 地理位置	其他	单个
乌江 平均流量	数字+单位	单个
乌江 中文名称	其他	单个
乌江 河长	数字+单位	单个
乌江 河流面积	数字+单位	单个
乌江 别称	其他	单个
乌江 流经地区	其他	多个
乌江 英文名称	其他	多个
乌江 所属水系	其他	单个
塔古斯河 平均流量	数字+单位	单个
塔古斯河 主要支流	百科实体	多个
塔古斯河 流域面积	数字+单位	单个
塔古斯河 外文名	其他	多个
塔古斯河 所属水系	其他	单个
阿尔丹河 平均流量	数字+单位	单个
阿尔丹河 主要支流	百科实体	多个
阿尔丹河 流域面积	数字+单位	单个
阿尔丹河 河流面积	数字+单位	单个
阿尔丹河 别称	其他	单个
阿尔丹河 外文名	其他	多个
阿尔丹河 流经地区	其他	多个
阿尔丹河 所属水系	其他	单个
利亚德河 平均流量	数字+单位	单个
利亚德河 主要支流	百科实体	多个
利亚德河 流域面积	数字+单位	单个
利亚德河 别称	其他	单个
利亚德河 外文名	其他	多个
利亚德河 所属水系	其他	单个
湄公河 地理位置	其他	单个
湄公河 平均流量	数字+单位	单个
湄公河 主要支流	百科实体	多个
湄公河 中文名称	其他	单个
湄公河 流域面积	数字+单位	单个
湄公河 河长	数字+单位	单个
湄公河 河流面积	数字+单位	单个
湄公河 别称	其他	单个
湄公河 发源地	其他	句子
湄公河 流经地区	其他	多个
湄公河 英文名称	其他	多个
湄公河 所属水系	其他	单个
卡马河 平均流量	数字+单位	单个
卡马河 流域面积	数字+单位	单个
卡马河 发源地	其他	句子
卡马河 外文名	其他	多个
布拉马普特拉河 地理位置	其他	单个
布拉马普特拉河 平均流量	数字+单位	单个
布拉马普特拉河 主要支流	百科实体	多个
布拉马普特拉河 中文名称	其他	单个
布拉马普特拉河 流域面积	数字+单位	单个
布拉马普特拉河 河长	数字+单位	单个
布拉马普特拉河 河流面积	数字+单位	单个
布拉马普特拉河 别称	其他	单个
布拉马普特拉河 发源地	其他	句子
布拉马普特拉河 流经地区	其他	多个
布拉马普特拉河 英文名称	其他	多个
布拉马普特拉河 所属水系	其他	单个
纳伦河 地理位置	其他	单个
纳伦河 平均流量	数字+单位	单个
纳伦河 主要支流	百科实体	多个
纳伦河 中文名称	其他	单个
纳伦河 河长	数字+单位	单个
纳伦河 河流面积	数字+单位	单个
纳伦河 别称	其他	单个
纳伦河 发源地	其他	句子
纳伦河 流经地区	其他	多个
纳伦河 英文名称	其他	多个
纳伦河 所属水系	其他	单个
通古斯河 平均流量	数字+单位	单个
通古斯河 主要支流	百科实体	多个
通古斯河 流域面积	数字+单位	单个
通古斯河 河长	数字+单位	单个
通古斯河 河流面积	数字+单位	单个
通古斯河 别称	其他	单个
通古斯河 发源地	其他	句子
通古斯河 外文名	其他	多个
通古斯河 流经地区	其他	多个
马莫雷河 地理位置	其他	单个
马莫雷河 平均流量	数字+单位	单个
马莫雷河 主要支流	百科实体	多个
马莫雷河 流域面积	数字+单位	单个
马莫雷河 河长	数字+单位	单个
马莫雷河 河流面积	数字+单位	单个
马莫雷河 别称	其他	单个
马莫雷河 外文名	其他	多个
马莫雷河 所属水系	其他	单个
萨拉多河 地理位置	其他	单个
萨拉多河 平均流量	数字+单位	单个
萨拉多河 主要支流	百科实体	多个
萨拉多河 中文名称	其他	单个
萨拉多河 流域面积	数字+单位	单个
萨拉多河 河长	数字+单位	单个
萨拉多河 河流面积	数字+单位	单个
萨拉多河 别称	其他	单个
萨拉多河 发源地	其他	句子
萨拉多河 流经地区	其他	多个
萨拉多河 英文名称	其他	多个
萨拉多河 所属水系	其他	单个
瓜维亚雷河 平均流量	数字+单位	单个
瓜维亚雷河 主要支流	百科实体	多个
瓜维亚雷河 流域面积	数字+单位	单个
瓜维亚雷河 河长	数字+单位	单个
瓜维亚雷河 河流面积	数字+单位	单个
瓜维亚雷河 别称	其他	单个
瓜维亚雷河 流经地区	其他	多个
瓜维亚雷河 英文名称	其他	多个
瓜维亚雷河 所属水系	其他	单个
郁江 地理位置	其他	单个
郁江 平均流量	数字+单位	单个
郁江 主要支流	百科实体	多个
郁江 中文名称	其他	单个
郁江 河流面积	数字+单位	单个
郁江 别称	其他	单个
郁江 外文名	其他	多个
郁江 英文名称	其他	多个
埃塞奎博河 地理位置	其他	单个
埃塞奎博河 平均流量	数字+单位	单个
埃塞奎博河 主要支流	百科实体	多个
埃塞奎博河 中文名称	其他	单个
埃塞奎博河 流域面积	数字+单位	单个
埃塞奎博河 河长	数字+单位	单个
埃塞奎博河 河流面积	数字+单位	单个
埃塞奎博河 别称	其他	单个
埃塞奎博河 流经地区	其他	多个
埃塞奎博河 英文名称	其他	多个
埃塞奎博河 所属水系	其他	单个
库拉河 地理位置	其他	单个
库拉河 平均流量	数字+单位	单个
库拉河 主要支流	百科实体	多个
库拉河 中文名称	其他	单个
库拉河 流域面积	数字+单位	单个
库拉河 河长	数字+单位	单个
库拉河 河流面积	数字+单位	单个
库拉河 别称	其他	单个
库拉河 发源地	其他	句子
库拉河 流经地区	其他	多个
库拉河 英文名称	其他	多个
库拉河 所属水系	其他	单个
比亚河 地理位置	其他	单个
比亚河 平均流量	数字+单位	单个
比亚河 主要支流	百科实体	多个
比亚河 中文名称	其他	单个
比亚河 流域面积	数字+单位	单个
比亚河 河长	数字+单位	单个
比亚河 河流面积	数字+单位	单个
比亚河 别称	其他	单个
比亚河 外文名	其他	多个
比亚河 流经地区	其他	多个
比亚河 英文名称	其他	多个
比亚河 所属水系	其他	单个
维亚特卡河 主要支流	百科实体	多个
维亚特卡河 流域面积	数字+单位	单个
维亚特卡河 别称	其他	单个
维亚特卡河 外文名	其他	多个
维亚特卡河 流经地区	其他	多个
朱巴河 平均流量	数字+单位	单个
朱巴河 主要支流	百科实体	多个
朱巴河 流域面积	数字+单位	单个
朱巴河 别称	其他	单个
朱巴河 外文名	其他	多个
朱巴河 所属水系	其他	单个
林波波河 地理位置	其他	单个
林波波河 平均流量	数字+单位	单个
林波波河 主要支流	百科实体	多个
林波波河 中文名称	其他	单个
林波波河 河长	数字+单位	单个
林波波河 河流面积	数字+单位	单个
林波波河 发源地	其他	句子
林波波河 流经地区	其他	多个
林波波河 英文名称	其他	多个
林波波河 所属水系	其他	单个
狮泉河 地理位置	其他	单个
狮泉河 平均流量	数字+单位	单个
狮泉河 主要支流	百科实体	多个
狮泉河 流域面积	数字+单位	单个
狮泉河 河长	数字+单位	单个
狮泉河 河流面积	数字+单位	单个
狮泉河 别称	其他	单个
狮泉河 发源地	其他	句子
狮泉河 流经地区	其他	多个
狮泉河 英文名称	其他	多个
狮泉河 所属水系	其他	单个
贝尼河 地理位置	其他	单个
贝尼河 平均流量	数字+单位	单个
贝尼河 主要支流	百科实体	多个
贝尼河 中文名称	其他	单个
贝尼河 流域面积	数字+单位	单个
贝尼河 河长	数字+单位	单个
贝尼河 河流面积	数字+单位	单个
贝尼河 别称	其他	单个
贝尼河 发源地	其他	句子
贝尼河 流经地区	其他	多个
贝尼河 英文名称	其他	多个
贝尼河 所属水系	其他	单个
伊里里河 地理位置	其他	单个
伊里里河 平均流量	数字+单位	单个
伊里里河 主要支流	百科实体	多个
伊里里河 中文名称	其他	单个
伊里里河 流域面积	数字+单位	单个
伊里里河 河长	数字+单位	单个
伊里里河 河流面积	数字+单位	单个
伊里里河 别称	其他	单个
伊里里河 发源地	其他	句子
伊里里河 流经地区	其他	多个
伊里里河 英文名称	其他	多个
伊里里河 所属水系	其他	单个
东江 地理位置	其他	单个
东江 平均流量	数字+单位	单个
东江 主要支流	百科实体	多个
东江 中文名称	其他	单个
东江 流域面积	数字+单位	单个
东江 河长	数字+单位	单个
东江 河流面积	数字+单位	单个
东江 别称	其他	单个
东江 发源地	其他	句子
东江 流经地区	其他	多个
东江 英文名称	其他	多个
东江 所属水系	其他	单个
圣克莱尔河 地理位置	其他	单个
圣克莱尔河 平均流量	数字+单位	单个
圣克莱尔河 主要支流	百科实体	多个
圣克莱尔河 中文名称	其他	单个
圣克莱尔河 流域面积	数字+单位	单个
圣克莱尔河 河长	数字+单位	单个
圣克莱尔河 河流面积	数字+单位	单个
圣克莱尔河 别称	其他	单个
圣克莱尔河 发源地	其他	句子
圣克莱尔河 流经地区	其他	多个
圣克莱尔河 英文名称	其他	多个
圣克莱尔河 所属水系	其他	单个
瓦亚加河 平均流量	数字+单位	单个
瓦亚加河 主要支流	百科实体	多个
瓦亚加河 流域面积	数字+单位	单个
瓦亚加河 河流面积	数字+单位	单个
瓦亚加河 外文名	其他	多个
密西西比河 主要支流	百科实体	多个
密西西比河 中文名称	其他	单个
密西西比河 河长	数字+单位	单个
密西西比河 河流面积	数字+单位	单个
密西西比河 别称	其他	单个
密西西比河 流经地区	其他	多个
密西西比河 英文名称	其他	多个
密西西比河 所属水系	其他	单个
塔帕若斯河 地理位置	其他	单个
塔帕若斯河 平均流量	数字+单位	单个
塔帕若斯河 流域面积	数字+单位	单个
塔帕若斯河 河长	数字+单位	单个
塔帕若斯河 河流面积	数字+单位	单个
塔帕若斯河 别称	其他	单个
塔帕若斯河 外文名	其他	多个
塔帕若斯河 英文名称	其他	多个
皮斯河 平均流量	数字+单位	单个
皮斯河 主要支流	百科实体	多个
皮斯河 流域面积	数字+单位	单个
皮斯河 河流面积	数字+单位	单个
皮斯河 别称	其他	单个
皮斯河 外文名	其他	多个
皮斯河 流经地区	其他	多个
皮斯河 英文名称	其他	多个
亚穆纳河 平均流量	数字+单位	单个
亚穆纳河 流域面积	数字+单位	单个
亚穆纳河 河流面积	数字+单位	单个
亚穆纳河 别称	其他	单个
亚穆纳河 外文名	其他	多个
伊瓜苏河 平均流量	数字+单位	单个
伊瓜苏河 主要支流	百科实体	多个
伊瓜苏河 流域面积	数字+单位	单个
伊瓜苏河 河流面积	数字+单位	单个
伊瓜苏河 外文名	其他	多个
乌伦古河 平均流量	数字+单位	单个
乌伦古河 流域面积	数字+单位	单个
乌伦古河 别称	其他	单个
乌伦古河 外文名	其他	多个
俄亥俄河 地理位置	其他	单个
俄亥俄河 主要支流	百科实体	多个
俄亥俄河 中文名称	其他	单个
俄亥俄河 流域面积	数字+单位	单个
俄亥俄河 河长	数字+单位	单个
俄亥俄河 河流面积	数字+单位	单个
俄亥俄河 别称	其他	单个
俄亥俄河 流经地区	其他	多个
俄亥俄河 英文名称	其他	多个
俄亥俄河 所属水系	其他	单个
铁特河 平均流量	数字+单位	单个
铁特河 主要支流	百科实体	多个
铁特河 河长	数字+单位	单个
铁特河 河流面积	数字+单位	单个
铁特河 别称	其他	单个
铁特河 发源地	其他	句子
铁特河 流经地区	其他	多个
铁特河 英文名称	其他	多个
铁特河 所属水系	其他	单个
伊犁河 地理位置	其他	单个
伊犁河 平均流量	数字+单位	单个
伊犁河 中文名称	其他	单个
伊犁河 河流面积	数字+单位	单个
伊犁河 别称	其他	单个
伊犁河 流经地区	其他	多个
伊犁河 英文名称	其他	多个
伊犁河 所属水系	其他	单个
哈坦加河 平均流量	数字+单位	单个
哈坦加河 主要支流	百科实体	多个
哈坦加河 流域面积	数字+单位	单个
哈坦加河 河长	数字+单位	单个
哈坦加河 河流面积	数字+单位	单个
哈坦加河 别称	其他	单个
哈坦加河 发源地	其他	句子
哈坦加河 流经地区	其他	多个
哈坦加河 英文名称	其他	多个
哈坦加河 所属水系	其他	单个
维柳伊河 平均流量	数字+单位	单个
维柳伊河 主要支流	百科实体	多个
维柳伊河 流域面积	数字+单位	单个
维柳伊河 河长	数字+单位	单个
维柳伊河 河流面积	数字+单位	单个
维柳伊河 别称	其他	单个
维柳伊河 发源地	其他	句子
维柳伊河 流经地区	其他	多个
维柳伊河 英文名称	其他	多个
维柳伊河 所属水系	其他	单个
伊洛瓦底江 地理位置	其他	单个
伊洛瓦底江 平均流量	数字+单位	单个
伊洛瓦底江 主要支流	百科实体	多个
伊洛瓦底江 中文名称	其他	单个
伊洛瓦底江 河长	数字+单位	单个
伊洛瓦底江 河流面积	数字+单位	单个
伊洛瓦底江 别称	其他	单个
伊洛瓦底江 发源地	其他	句子
伊洛瓦底江 流经地区	其他	多个
伊洛瓦底江 英文名称	其他	多个
伊洛瓦底江 所属水系	其他	单个
汾河 地理位置	其他	单个
汾河 平均流量	数字+单位	单个
汾河 中文名称	其他	单个
汾河 河流面积	数字+单位	单个
汾河 外文名	其他	多个
汾河 英文名称	其他	多个
德涅斯特河 地理位置	其他	单个
德涅斯特河 平均流量	数字+单位	单个
德涅斯特河 主要支流	百科实体	多个
德涅斯特河 中文名称	其他	单个
德涅斯特河 河长	数字+单位	单个
德涅斯特河 河流面积	数字+单位	单个
德涅斯特河 别称	其他	单个
德涅斯特河 流经地区	其他	多个
德涅斯特河 英文名称	其他	多个
德涅斯特河 所属水系	其他	单个
乌班吉河 地理位置	其他	单个
乌班吉河 平均流量	数字+单位	单个
乌班吉河 主要支流	百科实体	多个
乌班吉河 中文名称	其他	单个
乌班吉河 河长	数字+单位	单个
乌班吉河 河流面积	数字+单位	单个
乌班吉河 别称	其他	单个
乌班吉河 发源地	其他	句子
乌班吉河 流经地区	其他	多个
乌班吉河 英文名称	其他	多个
乌班吉河 所属水系	其他	单个
