大浪滩干盐湖 著名景点	其他	多个
大浪滩干盐湖 建议游玩时长	数字+单位	单个
大浪滩干盐湖 外文名称	其他	多个
大浪滩干盐湖 适宜游玩季节	数字+单位	单个
大浪滩干盐湖 所属城市	其他	句子
大浪滩干盐湖 所属国家	其他	多个
大浪滩干盐湖 门票价格	数字+单位	单个
大浪滩干盐湖 外文名	其他	多个
大浪滩干盐湖 开放时间	数字+单位	单个
大浪滩干盐湖 占地面积	数字+单位	单个
贝尔湖 建议游玩时长	数字+单位	单个
贝尔湖 适宜游玩季节	数字+单位	单个
贝尔湖 所属城市	其他	句子
洪泽湖 著名景点	其他	多个
洪泽湖 建议游玩时长	数字+单位	单个
洪泽湖 地理位置	其他	句子
洪泽湖 外文名称	其他	多个
洪泽湖 适宜游玩季节	数字+单位	单个
洪泽湖 所属城市	其他	句子
洪泽湖 中文名称	其他	单个
洪泽湖 所属国家	其他	多个
洪泽湖 门票价格	数字+单位	单个
洪泽湖 开放时间	数字+单位	单个
洪泽湖 占地面积	数字+单位	单个
昆明湖 著名景点	其他	多个
昆明湖 建议游玩时长	数字+单位	单个
昆明湖 外文名称	其他	多个
昆明湖 适宜游玩季节	数字+单位	单个
昆明湖 所属城市	其他	句子
昆明湖 中文名称	其他	单个
昆明湖 所属国家	其他	多个
昆明湖 门票价格	数字+单位	单个
昆明湖 外文名	其他	多个
昆明湖 开放时间	数字+单位	单个
昆明湖 占地面积	数字+单位	单个
兴凯湖 著名景点	其他	多个
兴凯湖 所属城市	其他	句子
兴凯湖 所属国家	其他	多个
玛纳斯湖 著名景点	其他	多个
玛纳斯湖 建议游玩时长	数字+单位	单个
玛纳斯湖 地理位置	其他	句子
玛纳斯湖 外文名称	其他	多个
玛纳斯湖 适宜游玩季节	数字+单位	单个
玛纳斯湖 所属城市	其他	句子
玛纳斯湖 面积	数字+单位	单个
玛纳斯湖 中文名称	其他	单个
玛纳斯湖 所属国家	其他	多个
玛纳斯湖 门票价格	数字+单位	单个
玛纳斯湖 外文名	其他	多个
玛纳斯湖 开放时间	数字+单位	单个
玛纳斯湖 占地面积	数字+单位	单个
苏必略湖 著名景点	其他	多个
苏必略湖 所属城市	其他	句子
苏必略湖 所属国家	其他	多个
玄武湖 建议游玩时长	数字+单位	单个
玄武湖 适宜游玩季节	数字+单位	单个
玄武湖 所属城市	其他	句子
玄武湖 所属国家	其他	多个
塔纳湖 著名景点	其他	多个
塔纳湖 建议游玩时长	数字+单位	单个
塔纳湖 地理位置	其他	句子
塔纳湖 外文名称	其他	多个
塔纳湖 适宜游玩季节	数字+单位	单个
塔纳湖 所属城市	其他	句子
塔纳湖 面积	数字+单位	单个
塔纳湖 中文名称	其他	单个
塔纳湖 所属国家	其他	多个
塔纳湖 门票价格	数字+单位	单个
塔纳湖 外文名	其他	多个
塔纳湖 开放时间	数字+单位	单个
塔纳湖 占地面积	数字+单位	单个
纳木错 地理位置	其他	句子
纳木错 外文名称	其他	多个
纳木错 所属城市	其他	句子
纳木错 中文名称	其他	单个
纳木错 所属国家	其他	多个
纳木错 占地面积	数字+单位	单个
坦噶尼喀湖 著名景点	其他	多个
坦噶尼喀湖 建议游玩时长	数字+单位	单个
坦噶尼喀湖 适宜游玩季节	数字+单位	单个
坦噶尼喀湖 所属城市	其他	句子
坦噶尼喀湖 所属国家	其他	多个
坦噶尼喀湖 门票价格	数字+单位	单个
坦噶尼喀湖 开放时间	数字+单位	单个
大奴湖 著名景点	其他	多个
大奴湖 建议游玩时长	数字+单位	单个
大奴湖 适宜游玩季节	数字+单位	单个
大奴湖 所属城市	其他	句子
大奴湖 面积	数字+单位	单个
大奴湖 所属国家	其他	多个
大奴湖 门票价格	数字+单位	单个
大奴湖 开放时间	数字+单位	单个
大奴湖 占地面积	数字+单位	单个
瘦西湖 所属国家	其他	多个
的的喀喀湖 地理位置	其他	句子
的的喀喀湖 占地面积	数字+单位	单个
龙感湖 建议游玩时长	数字+单位	单个
龙感湖 适宜游玩季节	数字+单位	单个
布伦托海 著名景点	其他	多个
布伦托海 建议游玩时长	数字+单位	单个
布伦托海 适宜游玩季节	数字+单位	单个
布伦托海 面积	数字+单位	单个
布伦托海 门票价格	数字+单位	单个
布伦托海 占地面积	数字+单位	单个
泸沽湖 著名景点	其他	多个
泸沽湖 建议游玩时长	数字+单位	单个
泸沽湖 外文名称	其他	多个
泸沽湖 适宜游玩季节	数字+单位	单个
泸沽湖 所属城市	其他	句子
泸沽湖 中文名称	其他	单个
泸沽湖 所属国家	其他	多个
泸沽湖 门票价格	数字+单位	单个
泸沽湖 开放时间	数字+单位	单个
泸沽湖 占地面积	数字+单位	单个
高邮湖 适宜游玩季节	数字+单位	单个
高邮湖 所属城市	其他	句子
高邮湖 所属国家	其他	多个
高邮湖 占地面积	数字+单位	单个
白洋淀 地理位置	其他	句子
白洋淀 外文名称	其他	多个
白洋淀 所属城市	其他	句子
白洋淀 中文名称	其他	单个
白洋淀 所属国家	其他	多个
白洋淀 门票价格	数字+单位	单个
白洋淀 占地面积	数字+单位	单个
星湖 地理位置	其他	句子
星湖 外文名称	其他	多个
星湖 所属城市	其他	句子
星湖 面积	数字+单位	单个
星湖 中文名称	其他	单个
星湖 所属国家	其他	多个
星湖 占地面积	数字+单位	单个
博斯腾湖 著名景点	其他	多个
博斯腾湖 建议游玩时长	数字+单位	单个
博斯腾湖 地理位置	其他	句子
博斯腾湖 外文名称	其他	多个
博斯腾湖 适宜游玩季节	数字+单位	单个
博斯腾湖 所属城市	其他	句子
博斯腾湖 中文名称	其他	单个
博斯腾湖 所属国家	其他	多个
博斯腾湖 门票价格	数字+单位	单个
博斯腾湖 开放时间	数字+单位	单个
博斯腾湖 占地面积	数字+单位	单个
乍得湖 著名景点	其他	多个
乍得湖 建议游玩时长	数字+单位	单个
乍得湖 外文名称	其他	多个
乍得湖 适宜游玩季节	数字+单位	单个
乍得湖 所属城市	其他	句子
乍得湖 所属国家	其他	多个
乍得湖 门票价格	数字+单位	单个
乍得湖 外文名	其他	多个
乍得湖 开放时间	数字+单位	单个
拉昂错 著名景点	其他	多个
拉昂错 建议游玩时长	数字+单位	单个
拉昂错 外文名称	其他	多个
拉昂错 适宜游玩季节	数字+单位	单个
拉昂错 面积	数字+单位	单个
拉昂错 中文名称	其他	单个
拉昂错 占地面积	数字+单位	单个
当惹雍错 著名景点	其他	多个
当惹雍错 建议游玩时长	数字+单位	单个
当惹雍错 外文名称	其他	多个
当惹雍错 适宜游玩季节	数字+单位	单个
当惹雍错 外文名	其他	多个
昆特依干盐湖 著名景点	其他	多个
昆特依干盐湖 建议游玩时长	数字+单位	单个
昆特依干盐湖 地理位置	其他	句子
昆特依干盐湖 外文名称	其他	多个
昆特依干盐湖 适宜游玩季节	数字+单位	单个
昆特依干盐湖 所属城市	其他	句子
昆特依干盐湖 中文名称	其他	单个
昆特依干盐湖 所属国家	其他	多个
昆特依干盐湖 门票价格	数字+单位	单个
昆特依干盐湖 外文名	其他	多个
昆特依干盐湖 开放时间	数字+单位	单个
昆特依干盐湖 占地面积	数字+单位	单个
色林错 著名景点	其他	多个
色林错 建议游玩时长	数字+单位	单个
色林错 外文名称	其他	多个
色林错 适宜游玩季节	数字+单位	单个
色林错 外文名	其他	多个
一里坪干盐湖 著名景点	其他	多个
一里坪干盐湖 建议游玩时长	数字+单位	单个
一里坪干盐湖 地理位置	其他	句子
一里坪干盐湖 外文名称	其他	多个
一里坪干盐湖 适宜游玩季节	数字+单位	单个
一里坪干盐湖 所属城市	其他	句子
一里坪干盐湖 中文名称	其他	单个
一里坪干盐湖 所属国家	其他	多个
一里坪干盐湖 门票价格	数字+单位	单个
一里坪干盐湖 外文名	其他	多个
一里坪干盐湖 开放时间	数字+单位	单个
一里坪干盐湖 占地面积	数字+单位	单个
格仁错 著名景点	其他	多个
格仁错 建议游玩时长	数字+单位	单个
格仁错 地理位置	其他	句子
格仁错 外文名称	其他	多个
格仁错 适宜游玩季节	数字+单位	单个
格仁错 所属城市	其他	句子
格仁错 面积	数字+单位	单个
格仁错 中文名称	其他	单个
格仁错 所属国家	其他	多个
格仁错 门票价格	数字+单位	单个
格仁错 开放时间	数字+单位	单个
格仁错 占地面积	数字+单位	单个
西湖 所属城市	其他	句子
西湖 所属国家	其他	多个
拉多加湖 著名景点	其他	多个
拉多加湖 建议游玩时长	数字+单位	单个
拉多加湖 地理位置	其他	句子
拉多加湖 外文名称	其他	多个
拉多加湖 适宜游玩季节	数字+单位	单个
拉多加湖 所属城市	其他	句子
拉多加湖 中文名称	其他	单个
拉多加湖 所属国家	其他	多个
拉多加湖 门票价格	数字+单位	单个
拉多加湖 开放时间	数字+单位	单个
拉多加湖 占地面积	数字+单位	单个
呼伦湖 著名景点	其他	多个
呼伦湖 外文名称	其他	多个
呼伦湖 外文名	其他	多个
呼伦湖 占地面积	数字+单位	单个
大熊湖 著名景点	其他	多个
大熊湖 建议游玩时长	数字+单位	单个
大熊湖 外文名称	其他	多个
大熊湖 适宜游玩季节	数字+单位	单个
大熊湖 所属城市	其他	句子
大熊湖 所属国家	其他	多个
大熊湖 门票价格	数字+单位	单个
大熊湖 外文名	其他	多个
大熊湖 开放时间	数字+单位	单个
鄂陵湖 外文名称	其他	多个
鄂陵湖 中文名称	其他	单个
鄂陵湖 外文名	其他	多个
鄂陵湖 占地面积	数字+单位	单个
扎日南木错 著名景点	其他	多个
扎日南木错 建议游玩时长	数字+单位	单个
扎日南木错 适宜游玩季节	数字+单位	单个
东湖 占地面积	数字+单位	单个
大明湖 所属国家	其他	多个
咸海 著名景点	其他	多个
咸海 建议游玩时长	数字+单位	单个
咸海 所属城市	其他	句子
咸海 所属国家	其他	多个
咸海 门票价格	数字+单位	单个
昂孜错 著名景点	其他	多个
昂孜错 建议游玩时长	数字+单位	单个
昂孜错 地理位置	其他	句子
昂孜错 外文名称	其他	多个
昂孜错 适宜游玩季节	数字+单位	单个
昂孜错 所属城市	其他	句子
昂孜错 面积	数字+单位	单个
昂孜错 中文名称	其他	单个
昂孜错 所属国家	其他	多个
昂孜错 门票价格	数字+单位	单个
昂孜错 开放时间	数字+单位	单个
昂孜错 占地面积	数字+单位	单个
安大略湖 著名景点	其他	多个
安大略湖 建议游玩时长	数字+单位	单个
安大略湖 地理位置	其他	句子
安大略湖 外文名称	其他	多个
安大略湖 适宜游玩季节	数字+单位	单个
安大略湖 所属城市	其他	句子
安大略湖 中文名称	其他	单个
安大略湖 所属国家	其他	多个
安大略湖 门票价格	数字+单位	单个
安大略湖 开放时间	数字+单位	单个
安大略湖 占地面积	数字+单位	单个
里海 建议游玩时长	数字+单位	单个
里海 适宜游玩季节	数字+单位	单个
里海 所属城市	其他	句子
里海 所属国家	其他	多个
多尔索洞错 著名景点	其他	多个
多尔索洞错 建议游玩时长	数字+单位	单个
多尔索洞错 地理位置	其他	句子
多尔索洞错 外文名称	其他	多个
多尔索洞错 适宜游玩季节	数字+单位	单个
多尔索洞错 所属城市	其他	句子
多尔索洞错 面积	数字+单位	单个
多尔索洞错 中文名称	其他	单个
多尔索洞错 所属国家	其他	多个
多尔索洞错 门票价格	数字+单位	单个
多尔索洞错 外文名	其他	多个
多尔索洞错 开放时间	数字+单位	单个
多尔索洞错 占地面积	数字+单位	单个
喀纳斯湖 著名景点	其他	多个
喀纳斯湖 所属城市	其他	句子
喀纳斯湖 所属国家	其他	多个
喀纳斯湖 占地面积	数字+单位	单个
奥涅加湖 著名景点	其他	多个
奥涅加湖 建议游玩时长	数字+单位	单个
奥涅加湖 地理位置	其他	句子
奥涅加湖 外文名称	其他	多个
奥涅加湖 适宜游玩季节	数字+单位	单个
奥涅加湖 所属城市	其他	句子
奥涅加湖 中文名称	其他	单个
奥涅加湖 门票价格	数字+单位	单个
奥涅加湖 开放时间	数字+单位	单个
奥涅加湖 占地面积	数字+单位	单个
巢湖 建议游玩时长	数字+单位	单个
巢湖 适宜游玩季节	数字+单位	单个
巢湖 所属城市	其他	句子
巢湖 所属国家	其他	多个
巢湖 门票价格	数字+单位	单个
巢湖 开放时间	数字+单位	单个
巢湖 占地面积	数字+单位	单个
哈拉湖 著名景点	其他	多个
哈拉湖 建议游玩时长	数字+单位	单个
哈拉湖 地理位置	其他	句子
哈拉湖 外文名称	其他	多个
哈拉湖 适宜游玩季节	数字+单位	单个
哈拉湖 所属城市	其他	句子
哈拉湖 中文名称	其他	单个
哈拉湖 所属国家	其他	多个
哈拉湖 门票价格	数字+单位	单个
哈拉湖 开放时间	数字+单位	单个
哈拉湖 占地面积	数字+单位	单个
维多利亚湖 著名景点	其他	多个
维多利亚湖 建议游玩时长	数字+单位	单个
维多利亚湖 地理位置	其他	句子
维多利亚湖 外文名称	其他	多个
维多利亚湖 适宜游玩季节	数字+单位	单个
维多利亚湖 所属城市	其他	句子
维多利亚湖 中文名称	其他	单个
维多利亚湖 所属国家	其他	多个
维多利亚湖 门票价格	数字+单位	单个
维多利亚湖 开放时间	数字+单位	单个
维多利亚湖 占地面积	数字+单位	单个
微山湖 著名景点	其他	多个
微山湖 建议游玩时长	数字+单位	单个
微山湖 外文名称	其他	多个
微山湖 所属城市	其他	句子
微山湖 中文名称	其他	单个
微山湖 所属国家	其他	多个
微山湖 门票价格	数字+单位	单个
微山湖 占地面积	数字+单位	单个
洞庭湖 建议游玩时长	数字+单位	单个
洞庭湖 外文名称	其他	多个
洞庭湖 适宜游玩季节	数字+单位	单个
洞庭湖 所属城市	其他	句子
洞庭湖 中文名称	其他	单个
洞庭湖 所属国家	其他	多个
洞庭湖 门票价格	数字+单位	单个
洞庭湖 开放时间	数字+单位	单个
洞庭湖 占地面积	数字+单位	单个
贝加尔湖 著名景点	其他	多个
贝加尔湖 建议游玩时长	数字+单位	单个
贝加尔湖 外文名称	其他	多个
贝加尔湖 适宜游玩季节	数字+单位	单个
贝加尔湖 所属城市	其他	句子
贝加尔湖 中文名称	其他	单个
贝加尔湖 所属国家	其他	多个
贝加尔湖 门票价格	数字+单位	单个
贝加尔湖 开放时间	数字+单位	单个
贝加尔湖 占地面积	数字+单位	单个
蠡湖 著名景点	其他	多个
蠡湖 建议游玩时长	数字+单位	单个
蠡湖 外文名称	其他	多个
蠡湖 适宜游玩季节	数字+单位	单个
蠡湖 外文名	其他	多个
鄱阳湖 著名景点	其他	多个
鄱阳湖 建议游玩时长	数字+单位	单个
鄱阳湖 外文名称	其他	多个
鄱阳湖 适宜游玩季节	数字+单位	单个
鄱阳湖 所属城市	其他	句子
鄱阳湖 面积	数字+单位	单个
鄱阳湖 中文名称	其他	单个
鄱阳湖 所属国家	其他	多个
鄱阳湖 门票价格	数字+单位	单个
鄱阳湖 开放时间	数字+单位	单个
鄱阳湖 占地面积	数字+单位	单个
船湾淡水湖 著名景点	其他	多个
船湾淡水湖 建议游玩时长	数字+单位	单个
船湾淡水湖 地理位置	其他	句子
船湾淡水湖 外文名称	其他	多个
船湾淡水湖 适宜游玩季节	数字+单位	单个
船湾淡水湖 所属城市	其他	句子
船湾淡水湖 面积	数字+单位	单个
船湾淡水湖 中文名称	其他	单个
船湾淡水湖 所属国家	其他	多个
船湾淡水湖 门票价格	数字+单位	单个
船湾淡水湖 外文名	其他	多个
船湾淡水湖 开放时间	数字+单位	单个
船湾淡水湖 占地面积	数字+单位	单个
西金乌兰湖 著名景点	其他	多个
西金乌兰湖 建议游玩时长	数字+单位	单个
西金乌兰湖 外文名称	其他	多个
西金乌兰湖 适宜游玩季节	数字+单位	单个
西金乌兰湖 所属城市	其他	句子
西金乌兰湖 面积	数字+单位	单个
西金乌兰湖 所属国家	其他	多个
西金乌兰湖 门票价格	数字+单位	单个
西金乌兰湖 外文名	其他	多个
西金乌兰湖 开放时间	数字+单位	单个
西金乌兰湖 占地面积	数字+单位	单个
马拉维湖 著名景点	其他	多个
马拉维湖 建议游玩时长	数字+单位	单个
马拉维湖 地理位置	其他	句子
马拉维湖 外文名称	其他	多个
马拉维湖 适宜游玩季节	数字+单位	单个
马拉维湖 所属城市	其他	句子
马拉维湖 中文名称	其他	单个
马拉维湖 所属国家	其他	多个
马拉维湖 门票价格	数字+单位	单个
马拉维湖 开放时间	数字+单位	单个
马拉维湖 占地面积	数字+单位	单个
阿雅克库木湖 著名景点	其他	多个
阿雅克库木湖 建议游玩时长	数字+单位	单个
阿雅克库木湖 地理位置	其他	句子
阿雅克库木湖 外文名称	其他	多个
阿雅克库木湖 适宜游玩季节	数字+单位	单个
阿雅克库木湖 所属城市	其他	句子
阿雅克库木湖 中文名称	其他	单个
阿雅克库木湖 所属国家	其他	多个
阿雅克库木湖 门票价格	数字+单位	单个
阿雅克库木湖 外文名	其他	多个
阿雅克库木湖 开放时间	数字+单位	单个
阿雅克库木湖 占地面积	数字+单位	单个
吴如错 著名景点	其他	多个
吴如错 建议游玩时长	数字+单位	单个
吴如错 地理位置	其他	句子
吴如错 外文名称	其他	多个
吴如错 适宜游玩季节	数字+单位	单个
吴如错 所属城市	其他	句子
吴如错 面积	数字+单位	单个
吴如错 中文名称	其他	单个
吴如错 所属国家	其他	多个
吴如错 门票价格	数字+单位	单个
吴如错 外文名	其他	多个
吴如错 开放时间	数字+单位	单个
吴如错 占地面积	数字+单位	单个
石湖 外文名称	其他	多个
石湖 外文名	其他	多个
赛里木湖 著名景点	其他	多个
赛里木湖 外文名称	其他	多个
赛里木湖 中文名称	其他	单个
连环湖 著名景点	其他	多个
连环湖 建议游玩时长	数字+单位	单个
连环湖 外文名称	其他	多个
连环湖 适宜游玩季节	数字+单位	单个
连环湖 外文名	其他	多个
金鸡湖 著名景点	其他	多个
金鸡湖 建议游玩时长	数字+单位	单个
金鸡湖 外文名称	其他	多个
金鸡湖 适宜游玩季节	数字+单位	单个
金鸡湖 所属城市	其他	句子
金鸡湖 所属国家	其他	多个
金鸡湖 外文名	其他	多个
金鸡湖 开放时间	数字+单位	单个
洞里萨湖 著名景点	其他	多个
洞里萨湖 外文名称	其他	多个
洞里萨湖 适宜游玩季节	数字+单位	单个
洞里萨湖 所属城市	其他	句子
洞里萨湖 中文名称	其他	单个
洞里萨湖 所属国家	其他	多个
洞里萨湖 占地面积	数字+单位	单个
梁子湖 建议游玩时长	数字+单位	单个
梁子湖 适宜游玩季节	数字+单位	单个
梁子湖 所属城市	其他	句子
梁子湖 所属国家	其他	多个
梁子湖 开放时间	数字+单位	单个
青海湖 著名景点	其他	多个
青海湖 门票价格	数字+单位	单个
青海湖 占地面积	数字+单位	单个
东钱湖 外文名称	其他	多个
东钱湖 所属城市	其他	句子
东钱湖 中文名称	其他	单个
东钱湖 所属国家	其他	多个
东钱湖 外文名	其他	多个
东钱湖 占地面积	数字+单位	单个
乌布苏湖 著名景点	其他	多个
乌布苏湖 建议游玩时长	数字+单位	单个
乌布苏湖 地理位置	其他	句子
乌布苏湖 外文名称	其他	多个
乌布苏湖 适宜游玩季节	数字+单位	单个
乌布苏湖 所属城市	其他	句子
乌布苏湖 中文名称	其他	单个
乌布苏湖 所属国家	其他	多个
乌布苏湖 门票价格	数字+单位	单个
乌布苏湖 外文名	其他	多个
乌布苏湖 开放时间	数字+单位	单个
乌布苏湖 占地面积	数字+单位	单个
罗布泊 地理位置	其他	句子
罗布泊 外文名称	其他	多个
罗布泊 面积	数字+单位	单个
罗布泊 中文名称	其他	单个
罗布泊 占地面积	数字+单位	单个
马拉开波湖 著名景点	其他	多个
马拉开波湖 建议游玩时长	数字+单位	单个
马拉开波湖 地理位置	其他	句子
马拉开波湖 外文名称	其他	多个
马拉开波湖 适宜游玩季节	数字+单位	单个
马拉开波湖 所属城市	其他	句子
马拉开波湖 中文名称	其他	单个
马拉开波湖 所属国家	其他	多个
马拉开波湖 门票价格	数字+单位	单个
马拉开波湖 开放时间	数字+单位	单个
马拉开波湖 占地面积	数字+单位	单个
乌兰乌拉湖 著名景点	其他	多个
乌兰乌拉湖 建议游玩时长	数字+单位	单个
乌兰乌拉湖 外文名称	其他	多个
乌兰乌拉湖 适宜游玩季节	数字+单位	单个
乌兰乌拉湖 所属城市	其他	句子
乌兰乌拉湖 所属国家	其他	多个
乌兰乌拉湖 门票价格	数字+单位	单个
乌兰乌拉湖 外文名	其他	多个
乌兰乌拉湖 开放时间	数字+单位	单个
乌兰乌拉湖 占地面积	数字+单位	单个
洪湖 建议游玩时长	数字+单位	单个
洪湖 适宜游玩季节	数字+单位	单个
洪湖 所属城市	其他	句子
洪湖 所属国家	其他	多个
洪湖 门票价格	数字+单位	单个
洪湖 开放时间	数字+单位	单个
洪湖 占地面积	数字+单位	单个
沃斯托克湖 著名景点	其他	多个
沃斯托克湖 建议游玩时长	数字+单位	单个
沃斯托克湖 地理位置	其他	句子
沃斯托克湖 适宜游玩季节	数字+单位	单个
沃斯托克湖 所属城市	其他	句子
沃斯托克湖 所属国家	其他	多个
沃斯托克湖 门票价格	数字+单位	单个
沃斯托克湖 开放时间	数字+单位	单个
沃斯托克湖 占地面积	数字+单位	单个
昂拉仁错 著名景点	其他	多个
昂拉仁错 建议游玩时长	数字+单位	单个
昂拉仁错 地理位置	其他	句子
昂拉仁错 外文名称	其他	多个
昂拉仁错 适宜游玩季节	数字+单位	单个
昂拉仁错 所属城市	其他	句子
昂拉仁错 中文名称	其他	单个
昂拉仁错 所属国家	其他	多个
昂拉仁错 门票价格	数字+单位	单个
昂拉仁错 外文名	其他	多个
昂拉仁错 开放时间	数字+单位	单个
昂拉仁错 占地面积	数字+单位	单个
伊利湖 著名景点	其他	多个
伊利湖 建议游玩时长	数字+单位	单个
伊利湖 地理位置	其他	句子
伊利湖 外文名称	其他	多个
伊利湖 适宜游玩季节	数字+单位	单个
伊利湖 所属城市	其他	句子
伊利湖 中文名称	其他	单个
伊利湖 所属国家	其他	多个
伊利湖 门票价格	数字+单位	单个
伊利湖 开放时间	数字+单位	单个
伊利湖 占地面积	数字+单位	单个
太湖 著名景点	其他	多个
太湖 所属城市	其他	句子
太湖 占地面积	数字+单位	单个
班公错 外文名称	其他	多个
班公错 外文名	其他	多个
巴尔喀什湖 著名景点	其他	多个
巴尔喀什湖 建议游玩时长	数字+单位	单个
巴尔喀什湖 地理位置	其他	句子
巴尔喀什湖 外文名称	其他	多个
巴尔喀什湖 适宜游玩季节	数字+单位	单个
巴尔喀什湖 所属城市	其他	句子
巴尔喀什湖 中文名称	其他	单个
巴尔喀什湖 所属国家	其他	多个
巴尔喀什湖 门票价格	数字+单位	单个
巴尔喀什湖 开放时间	数字+单位	单个
巴尔喀什湖 占地面积	数字+单位	单个
密歇根湖 著名景点	其他	多个
密歇根湖 建议游玩时长	数字+单位	单个
密歇根湖 地理位置	其他	句子
密歇根湖 适宜游玩季节	数字+单位	单个
密歇根湖 所属城市	其他	句子
密歇根湖 所属国家	其他	多个
密歇根湖 门票价格	数字+单位	单个
密歇根湖 开放时间	数字+单位	单个
密歇根湖 占地面积	数字+单位	单个
可可西里湖 著名景点	其他	多个
可可西里湖 建议游玩时长	数字+单位	单个
可可西里湖 地理位置	其他	句子
可可西里湖 外文名称	其他	多个
可可西里湖 适宜游玩季节	数字+单位	单个
可可西里湖 所属城市	其他	句子
可可西里湖 面积	数字+单位	单个
可可西里湖 中文名称	其他	单个
可可西里湖 所属国家	其他	多个
可可西里湖 门票价格	数字+单位	单个
可可西里湖 外文名	其他	多个
可可西里湖 开放时间	数字+单位	单个
可可西里湖 占地面积	数字+单位	单个
仙女湖 著名景点	其他	多个
仙女湖 建议游玩时长	数字+单位	单个
仙女湖 地理位置	其他	句子
仙女湖 外文名称	其他	多个
仙女湖 适宜游玩季节	数字+单位	单个
仙女湖 所属城市	其他	句子
仙女湖 面积	数字+单位	单个
仙女湖 中文名称	其他	单个
仙女湖 所属国家	其他	多个
仙女湖 门票价格	数字+单位	单个
仙女湖 开放时间	数字+单位	单个
仙女湖 占地面积	数字+单位	单个
玛旁雍错 著名景点	其他	多个
玛旁雍错 建议游玩时长	数字+单位	单个
玛旁雍错 地理位置	其他	句子
玛旁雍错 所属城市	其他	句子
玛旁雍错 面积	数字+单位	单个
玛旁雍错 所属国家	其他	多个
玛旁雍错 占地面积	数字+单位	单个
弗里克塞尔湖 著名景点	其他	多个
弗里克塞尔湖 建议游玩时长	数字+单位	单个
弗里克塞尔湖 地理位置	其他	句子
弗里克塞尔湖 外文名称	其他	多个
弗里克塞尔湖 适宜游玩季节	数字+单位	单个
弗里克塞尔湖 所属城市	其他	句子
弗里克塞尔湖 面积	数字+单位	单个
弗里克塞尔湖 中文名称	其他	单个
弗里克塞尔湖 所属国家	其他	多个
弗里克塞尔湖 门票价格	数字+单位	单个
弗里克塞尔湖 开放时间	数字+单位	单个
弗里克塞尔湖 占地面积	数字+单位	单个
北艾尔湖 著名景点	其他	多个
北艾尔湖 建议游玩时长	数字+单位	单个
北艾尔湖 外文名称	其他	多个
北艾尔湖 适宜游玩季节	数字+单位	单个
北艾尔湖 所属城市	其他	句子
北艾尔湖 所属国家	其他	多个
北艾尔湖 门票价格	数字+单位	单个
北艾尔湖 外文名	其他	多个
北艾尔湖 开放时间	数字+单位	单个
北艾尔湖 占地面积	数字+单位	单个
休伦湖 著名景点	其他	多个
休伦湖 建议游玩时长	数字+单位	单个
休伦湖 地理位置	其他	句子
休伦湖 外文名称	其他	多个
休伦湖 适宜游玩季节	数字+单位	单个
休伦湖 所属城市	其他	句子
休伦湖 中文名称	其他	单个
休伦湖 门票价格	数字+单位	单个
休伦湖 开放时间	数字+单位	单个
休伦湖 占地面积	数字+单位	单个
塔若错 著名景点	其他	多个
塔若错 建议游玩时长	数字+单位	单个
塔若错 地理位置	其他	句子
塔若错 外文名称	其他	多个
塔若错 适宜游玩季节	数字+单位	单个
塔若错 所属城市	其他	句子
塔若错 中文名称	其他	单个
塔若错 所属国家	其他	多个
塔若错 门票价格	数字+单位	单个
塔若错 外文名	其他	多个
塔若错 开放时间	数字+单位	单个
塔若错 占地面积	数字+单位	单个
滇池 著名景点	其他	多个
滇池 建议游玩时长	数字+单位	单个
滇池 外文名称	其他	多个
滇池 适宜游玩季节	数字+单位	单个
滇池 所属城市	其他	句子
滇池 中文名称	其他	单个
滇池 所属国家	其他	多个
滇池 门票价格	数字+单位	单个
滇池 外文名	其他	多个
滇池 开放时间	数字+单位	单个
滇池 占地面积	数字+单位	单个
艾比湖 著名景点	其他	多个
艾比湖 建议游玩时长	数字+单位	单个
艾比湖 地理位置	其他	句子
艾比湖 外文名称	其他	多个
艾比湖 适宜游玩季节	数字+单位	单个
艾比湖 所属城市	其他	句子
艾比湖 中文名称	其他	单个
艾比湖 所属国家	其他	多个
艾比湖 门票价格	数字+单位	单个
艾比湖 开放时间	数字+单位	单个
艾比湖 占地面积	数字+单位	单个
