天台盆地 外文名	其他	多个
天台盆地 地理位置	其他	句子
天台盆地 面积	数字+单位	单个
天台盆地 中文名称	其他	单个
吐鲁番盆地 地理位置	其他	句子
吐鲁番盆地 中文名称	其他	单个
西伯利亚盆地 外文名	其他	多个
西伯利亚盆地 地理位置	其他	句子
西伯利亚盆地 中文名称	其他	单个
南阳盆地 外文名	其他	多个
汉中盆地 面积	数字+单位	单个
汉中盆地 中文名称	其他	单个
上党盆地 外文名	其他	多个
柴达木盆地 外文名	其他	多个
渤海—华北盆地 地理位置	其他	句子
渤海—华北盆地 中文名称	其他	单个
准噶尔盆地 中文名称	其他	单个
尼罗河上游盆地 外文名	其他	多个
尼罗河上游盆地 地理位置	其他	句子
尼罗河上游盆地 中文名称	其他	单个
刚果盆地 中文名称	其他	单个
金衢盆地 外文名	其他	多个
金衢盆地 地理位置	其他	句子
金衢盆地 面积	数字+单位	单个
金衢盆地 中文名称	其他	单个
广西盆地 外文名	其他	多个
广西盆地 地理位置	其他	句子
广西盆地 面积	数字+单位	单个
广西盆地 中文名称	其他	单个
南亚大盆地 外文名	其他	多个
南亚大盆地 地理位置	其他	句子
南亚大盆地 面积	数字+单位	单个
南亚大盆地 中文名称	其他	单个
卡拉哈迪盆地 外文名	其他	多个
卡拉哈迪盆地 中文名称	其他	单个
丹阳盆地 外文名	其他	多个
丹阳盆地 地理位置	其他	句子
丹阳盆地 中文名称	其他	单个
晋城盆地 地理位置	其他	句子
晋城盆地 中文名称	其他	单个
焉耆盆地 外文名	其他	多个
焉耆盆地 地理位置	其他	句子
焉耆盆地 中文名称	其他	单个
晋中盆地 地理位置	其他	句子
晋中盆地 中文名称	其他	单个
乍得盆地 地理位置	其他	句子
乍得盆地 中文名称	其他	单个
徽成盆地 面积	数字+单位	单个
徽成盆地 中文名称	其他	单个
南美大盆地 外文名	其他	多个
南美大盆地 地理位置	其他	句子
南美大盆地 面积	数字+单位	单个
南美大盆地 中文名称	其他	单个
衡阳盆地 外文名	其他	多个
衡阳盆地 地理位置	其他	句子
衡阳盆地 中文名称	其他	单个
长治盆地 外文名	其他	多个
运城盆地 外文名	其他	多个
费尔干纳盆地 外文名	其他	多个
费尔干纳盆地 地理位置	其他	句子
费尔干纳盆地 面积	数字+单位	单个
大自流盆地 地理位置	其他	句子
大自流盆地 中文名称	其他	单个
巴里坤盆地 外文名	其他	多个
巴里坤盆地 地理位置	其他	句子
巴里坤盆地 面积	数字+单位	单个
巴里坤盆地 中文名称	其他	单个
里海盆地 地理位置	其他	句子
里海盆地 中文名称	其他	单个
四川盆地 地理位置	其他	句子
四川盆地 中文名称	其他	单个
诸暨盆地 外文名	其他	多个
诸暨盆地 地理位置	其他	句子
诸暨盆地 面积	数字+单位	单个
诸暨盆地 中文名称	其他	单个
库木库勒盆地 面积	数字+单位	单个
库木库勒盆地 中文名称	其他	单个
洛阳盆地 中文名称	其他	单个
波斯湾盆地 外文名	其他	多个
波斯湾盆地 地理位置	其他	句子
波斯湾盆地 中文名称	其他	单个
陕甘宁盆地 外文名	其他	多个
陕甘宁盆地 地理位置	其他	句子
陕甘宁盆地 面积	数字+单位	单个
陕甘宁盆地 中文名称	其他	单个
关中盆地 面积	数字+单位	单个
关中盆地 中文名称	其他	单个
大同盆地 外文名	其他	多个
大同盆地 地理位置	其他	句子
大同盆地 中文名称	其他	单个
