恒河平原 主要城市	地名	多个
恒河平原 位于	其他	句子
中欧平原 主要城市	地名	多个
中欧平原 地理位置	其他	句子
中欧平原 位于	其他	句子
中欧平原 中文名称	其他	单个
中欧平原 外文名称	其他	多个
东北平原 地理位置	其他	句子
东北平原 位于	其他	句子
东北平原 中文名称	其他	单个
东北平原 外文名称	其他	多个
成都平原 地理位置	其他	句子
成都平原 位于	其他	句子
成都平原 中文名称	其他	单个
成都平原 外文名称	其他	多个
东欧平原 主要城市	地名	多个
东欧平原 位于	其他	句子
东欧平原 中文名称	其他	单个
东欧平原 外文名称	其他	多个
拉普拉塔平原 主要城市	地名	多个
拉普拉塔平原 外文名	其他	多个
拉普拉塔平原 地理位置	其他	句子
拉普拉塔平原 位于	其他	句子
拉普拉塔平原 中文名称	其他	单个
拉普拉塔平原 外文名称	其他	多个
红河平原 主要城市	地名	多个
红河平原 外文名	其他	多个
红河平原 地理位置	其他	句子
红河平原 位于	其他	句子
红河平原 中文名称	其他	单个
红河平原 外文名称	其他	多个
西欧平原 主要城市	地名	多个
西欧平原 地理位置	其他	句子
西欧平原 面积	数字+单位	单个
西欧平原 中文名称	其他	单个
西欧平原 外文名称	其他	多个
亚马孙平原 主要城市	地名	多个
亚马孙平原 位于	其他	句子
渭河平原 主要城市	地名	多个
渭河平原 面积	数字+单位	单个
渭河平原 位于	其他	句子
渭河平原 中文名称	其他	单个
渭河平原 外文名称	其他	多个
美索不达米亚平原 主要城市	地名	多个
美索不达米亚平原 外文名	其他	多个
美索不达米亚平原 面积	数字+单位	单个
美索不达米亚平原 位于	其他	句子
美索不达米亚平原 中文名称	其他	单个
美索不达米亚平原 外文名称	其他	多个
浓尾平原 主要城市	地名	多个
浓尾平原 外文名	其他	多个
浓尾平原 地理位置	其他	句子
浓尾平原 中文名称	其他	单个
浓尾平原 外文名称	其他	多个
波德平原 主要城市	地名	多个
波德平原 地理位置	其他	句子
波德平原 位于	其他	句子
波德平原 中文名称	其他	单个
波德平原 外文名称	其他	多个
湄南河平原 主要城市	地名	多个
湄南河平原 外文名	其他	多个
湄南河平原 地理位置	其他	句子
湄南河平原 中文名称	其他	单个
湄南河平原 外文名称	其他	多个
中部平原 主要城市	地名	多个
中部平原 外文名	其他	多个
中部平原 地理位置	其他	句子
中部平原 面积	数字+单位	单个
中部平原 中文名称	其他	单个
中部平原 外文名称	其他	多个
珠江三角洲平原 外文名	其他	多个
珠江三角洲平原 地理位置	其他	句子
珠江三角洲平原 位于	其他	句子
珠江三角洲平原 中文名称	其他	单个
珠江三角洲平原 外文名称	其他	多个
华北平原 位于	其他	句子
图兰平原 主要城市	地名	多个
图兰平原 位于	其他	句子
西西伯利亚平原 地理位置	其他	句子
西西伯利亚平原 位于	其他	句子
印度河平原 主要城市	地名	多个
印度河平原 位于	其他	句子
印度河平原 中文名称	其他	单个
印度河平原 外文名称	其他	多个
潮汕平原 主要城市	地名	多个
潮汕平原 外文名	其他	多个
潮汕平原 位于	其他	句子
潮汕平原 外文名称	其他	多个
嘉南平原 主要城市	地名	多个
嘉南平原 外文名	其他	多个
嘉南平原 地理位置	其他	句子
嘉南平原 位于	其他	句子
嘉南平原 外文名称	其他	多个
长江中下游平原 地理位置	其他	句子
长江中下游平原 位于	其他	句子
长江中下游平原 中文名称	其他	单个
长江中下游平原 外文名称	其他	多个
波河平原 主要城市	地名	多个
波河平原 地理位置	其他	句子
波河平原 面积	数字+单位	单个
波河平原 中文名称	其他	单个
波河平原 外文名称	其他	多个
