极地冰原气候 成因	百科实体	单个
极地冰原气候 气候特征	其他	句子
极地冰原气候 代表城市	地名	单个
热带沙漠气候 气候特征	其他	句子
热带沙漠气候 代表城市	地名	单个
温带季风气候 成因	百科实体	单个
温带季风气候 气候特征	其他	句子
极地苔原气候 成因	百科实体	单个
极地苔原气候 气候特征	其他	句子
极地苔原气候 代表城市	地名	单个
温带海洋性气候 成因	百科实体	单个
温带海洋性气候 代表城市	地名	单个
热带季风气候 成因	百科实体	单个
热带季风气候 气候特征	其他	句子
热带季风气候 代表城市	地名	单个
热带雨林气候 气候特征	其他	句子
热带雨林气候 代表城市	地名	单个
高原山地气候 成因	百科实体	单个
高原山地气候 气候特征	其他	句子
高原山地气候 代表城市	地名	单个
亚热带季风气候 成因	百科实体	单个
亚热带季风气候 代表城市	地名	单个
温带大陆性气候 成因	百科实体	单个
温带大陆性气候 代表城市	地名	单个
