副热带高气压带 天气形成	百科实体	多个
副热带高气压带 形成机制	百科实体	单个
副热带高气压带 年平均气温	数字+单位	单个
副热带高气压带 年降水量	数字+单位	单个
副热带高气压带 分布区域	百科实体	多个
副热带高气压带 外文名	百科实体	多个
副热带高气压带 气候形成	百科实体	单个
副热带高气压带 特点	百科实体	多个
副极地低气压带 英文名称	百科实体	多个
副极地低气压带 年平均气温	数字+单位	单个
副极地低气压带 年降水量	数字+单位	单个
副极地低气压带 中文名称	其他	单个
副极地低气压带 别称	其他	单个
赤道低气压带 天气形成	百科实体	多个
赤道低气压带 形成机制	百科实体	单个
赤道低气压带 英文名称	百科实体	多个
赤道低气压带 分布区域	百科实体	多个
赤道低气压带 气候形成	百科实体	单个
赤道低气压带 中文名称	其他	单个
赤道低气压带 特点	百科实体	多个
赤道低气压带 别称	其他	单个
