内盖夫沙漠 气候条件	其他	句子
内盖夫沙漠 地理位置	其他	句子
内盖夫沙漠 面积	数字+单位	单个
内盖夫沙漠 中文名称	其他	句子
内盖夫沙漠 外文名称	其他	多个
内盖夫沙漠 所属国家	百科实体	单个
乌兰布和沙漠 气候条件	其他	句子
乌兰布和沙漠 外文名	其他	多个
乌兰布和沙漠 地理位置	其他	句子
乌兰布和沙漠 外文名称	其他	多个
索诺兰沙漠 地理位置	其他	句子
索诺兰沙漠 所属国家	百科实体	单个
塔尔沙漠 所属国家	百科实体	单个
戈壁沙漠 气候条件	其他	句子
戈壁沙漠 所属国家	百科实体	单个
巴塔哥尼亚 所属国家	百科实体	单个
塔克拉玛干沙漠 所属国家	百科实体	单个
西奈沙漠 气候条件	其他	句子
西奈沙漠 地理位置	其他	句子
西奈沙漠 面积	数字+单位	单个
西奈沙漠 中文名称	其他	句子
西奈沙漠 外文名称	其他	多个
西奈沙漠 所属国家	百科实体	单个
毛乌素沙漠 气候条件	其他	句子
毛乌素沙漠 地理位置	其他	句子
毛乌素沙漠 面积	数字+单位	单个
卡拉库姆沙漠 气候条件	其他	句子
卡拉库姆沙漠 地理位置	其他	句子
卡拉库姆沙漠 中文名称	其他	句子
卡拉库姆沙漠 外文名称	其他	多个
卡拉库姆沙漠 所属国家	百科实体	单个
腾格里沙漠 气候条件	其他	句子
腾格里沙漠 地理位置	其他	句子
腾格里沙漠 中文名称	其他	句子
腾格里沙漠 外文名称	其他	多个
腾格里沙漠 所属国家	百科实体	单个
莫哈韦沙漠 气候条件	其他	句子
莫哈韦沙漠 所属国家	百科实体	单个
奇瓦瓦沙漠 气候条件	其他	句子
奇瓦瓦沙漠 地理位置	其他	句子
奇瓦瓦沙漠 面积	数字+单位	单个
奇瓦瓦沙漠 中文名称	其他	句子
奇瓦瓦沙漠 外文名称	其他	多个
奇瓦瓦沙漠 所属国家	百科实体	单个
喀拉哈里沙漠 气候条件	其他	句子
喀拉哈里沙漠 地理位置	其他	句子
喀拉哈里沙漠 中文名称	其他	句子
喀拉哈里沙漠 外文名称	其他	多个
喀拉哈里沙漠 所属国家	百科实体	单个
阿拉伯沙漠 中文名称	其他	句子
阿拉伯沙漠 外文名称	其他	多个
阿拉伯沙漠 所属国家	百科实体	单个
撒哈拉沙漠 气候条件	其他	句子
撒哈拉沙漠 中文名称	其他	句子
撒哈拉沙漠 外文名称	其他	多个
撒哈拉沙漠 所属国家	百科实体	单个
巴丹吉林沙漠 外文名	其他	多个
巴丹吉林沙漠 外文名称	其他	多个
巴丹吉林沙漠 所属国家	百科实体	单个
古尔班通古特沙漠 气候条件	其他	句子
古尔班通古特沙漠 外文名	其他	多个
古尔班通古特沙漠 中文名称	其他	句子
古尔班通古特沙漠 外文名称	其他	多个
库布其沙漠 气候条件	其他	句子
库布其沙漠 外文名	其他	多个
库布其沙漠 面积	数字+单位	单个
库布其沙漠 中文名称	其他	句子
库布其沙漠 外文名称	其他	多个
纳米比沙漠 气候条件	其他	句子
纳米比沙漠 中文名称	其他	句子
纳米比沙漠 外文名称	其他	多个
纳米比沙漠 所属国家	百科实体	单个
卢特沙漠 气候条件	其他	句子
卢特沙漠 地理位置	其他	句子
卢特沙漠 中文名称	其他	句子
卢特沙漠 外文名称	其他	多个
阿塔卡马沙漠 气候条件	其他	句子
阿塔卡马沙漠 地理位置	其他	句子
阿塔卡马沙漠 中文名称	其他	句子
阿塔卡马沙漠 外文名称	其他	多个
