巫山山脉 长度	数字+单位	单个
巫山山脉 主峰	其他	单个
巫山山脉 著名景点	百科实体	多个
巫山山脉 海拔	数字+单位	单个
东马德雷山脉 长度	数字+单位	单个
东马德雷山脉 主峰	其他	单个
东马德雷山脉 著名景点	百科实体	多个
东马德雷山脉 海拔	数字+单位	单个
东马德雷山脉 地理位置	其他	句子
东马德雷山脉 中文名称	其他	单个
维尔霍扬斯克山脉 主峰	其他	单个
维尔霍扬斯克山脉 著名景点	百科实体	多个
维尔霍扬斯克山脉 海拔	数字+单位	单个
维尔霍扬斯克山脉 地理位置	其他	句子
维尔霍扬斯克山脉 外文名	其他	多个
维尔霍扬斯克山脉 中文名称	其他	单个
托罗斯山脉 长度	数字+单位	单个
托罗斯山脉 主峰	其他	单个
托罗斯山脉 著名景点	百科实体	多个
托罗斯山脉 海拔	数字+单位	单个
托罗斯山脉 地理位置	其他	句子
托罗斯山脉 中文名称	其他	单个
天目山脉 长度	数字+单位	单个
天目山脉 主峰	其他	单个
天目山脉 著名景点	百科实体	多个
苏莱曼山脉 长度	数字+单位	单个
苏莱曼山脉 著名景点	百科实体	多个
苏莱曼山脉 地理位置	其他	句子
苏莱曼山脉 外文名	其他	多个
苏莱曼山脉 中文名称	其他	单个
冈底斯山脉 长度	数字+单位	单个
冈底斯山脉 主峰	其他	单个
冈底斯山脉 著名景点	百科实体	多个
冈底斯山脉 海拔	数字+单位	单个
冈底斯山脉 地理位置	其他	句子
冈底斯山脉 中文名称	其他	单个
阿哈加尔山脉 长度	数字+单位	单个
阿哈加尔山脉 主峰	其他	单个
阿哈加尔山脉 著名景点	百科实体	多个
阿哈加尔山脉 地理位置	其他	句子
阿哈加尔山脉 外文名	其他	多个
阿哈加尔山脉 中文名称	其他	单个
克拉克山脉 长度	数字+单位	单个
克拉克山脉 主峰	其他	单个
克拉克山脉 著名景点	百科实体	多个
克拉克山脉 海拔	数字+单位	单个
克拉克山脉 地理位置	其他	句子
克拉克山脉 外文名	其他	多个
克拉克山脉 中文名称	其他	单个
太行山 长度	数字+单位	单个
太行山 主峰	其他	单个
太行山 著名景点	百科实体	多个
太行山 海拔	数字+单位	单个
太行山 地理位置	其他	句子
太行山 中文名称	其他	单个
天台山脉 长度	数字+单位	单个
天台山脉 著名景点	百科实体	多个
天台山脉 海拔	数字+单位	单个
天台山脉 外文名	其他	多个
熊耳山 长度	数字+单位	单个
熊耳山 著名景点	百科实体	多个
熊耳山 地理位置	其他	句子
熊耳山 外文名	其他	多个
熊耳山 中文名称	其他	单个
鹦哥岭 长度	数字+单位	单个
鹦哥岭 主峰	其他	单个
鹦哥岭 海拔	数字+单位	单个
鹦哥岭 外文名	其他	多个
赤石山脉 长度	数字+单位	单个
赤石山脉 主峰	其他	单个
赤石山脉 著名景点	百科实体	多个
赤石山脉 地理位置	其他	句子
赤石山脉 中文名称	其他	单个
昆仑山脉 长度	数字+单位	单个
昆仑山脉 主峰	其他	单个
昆仑山脉 著名景点	百科实体	多个
昆仑山脉 中文名称	其他	单个
俾斯麦山脉 长度	数字+单位	单个
俾斯麦山脉 著名景点	百科实体	多个
俾斯麦山脉 海拔	数字+单位	单个
俾斯麦山脉 外文名	其他	多个
大兴安岭山脉 外文名	其他	多个
天平山 长度	数字+单位	单个
天平山 主峰	其他	单个
天平山 海拔	数字+单位	单个
飞驒山脉 长度	数字+单位	单个
飞驒山脉 主峰	其他	单个
飞驒山脉 著名景点	百科实体	多个
飞驒山脉 地理位置	其他	句子
飞驒山脉 中文名称	其他	单个
蓝山山脉 长度	数字+单位	单个
蓝山山脉 主峰	其他	单个
蓝山山脉 海拔	数字+单位	单个
萌渚岭 长度	数字+单位	单个
萌渚岭 主峰	其他	单个
萌渚岭 著名景点	百科实体	多个
萌渚岭 海拔	数字+单位	单个
萌渚岭 外文名	其他	多个
喀喇昆仑山脉 著名景点	百科实体	多个
喀喇昆仑山脉 中文名称	其他	单个
合黎山 长度	数字+单位	单个
合黎山 主峰	其他	单个
合黎山 著名景点	百科实体	多个
合黎山 地理位置	其他	句子
合黎山 外文名	其他	多个
合黎山 中文名称	其他	单个
武夷山脉 著名景点	百科实体	多个
武夷山脉 外文名	其他	多个
厄尔布尔士山脉 长度	数字+单位	单个
厄尔布尔士山脉 著名景点	百科实体	多个
厄尔布尔士山脉 中文名称	其他	单个
新几内亚高地 长度	数字+单位	单个
新几内亚高地 主峰	其他	单个
新几内亚高地 著名景点	百科实体	多个
新几内亚高地 海拔	数字+单位	单个
新几内亚高地 地理位置	其他	句子
新几内亚高地 外文名	其他	多个
新几内亚高地 中文名称	其他	单个
内华达山脉 长度	数字+单位	单个
内华达山脉 主峰	其他	单个
内华达山脉 著名景点	百科实体	多个
内华达山脉 地理位置	其他	句子
内华达山脉 中文名称	其他	单个
云居山 长度	数字+单位	单个
云居山 主峰	其他	单个
云居山 海拔	数字+单位	单个
云居山 地理位置	其他	句子
大分水岭 主峰	其他	单个
大分水岭 著名景点	百科实体	多个
大分水岭 海拔	数字+单位	单个
大分水岭 外文名	其他	多个
九华山 长度	数字+单位	单个
九华山 海拔	数字+单位	单个
茅山山脉 长度	数字+单位	单个
茅山山脉 主峰	其他	单个
茅山山脉 著名景点	百科实体	多个
茅山山脉 海拔	数字+单位	单个
茅山山脉 地理位置	其他	句子
茅山山脉 外文名	其他	多个
茅山山脉 中文名称	其他	单个
阿尔金山脉 长度	数字+单位	单个
阿尔金山脉 主峰	其他	单个
阿尔金山脉 著名景点	百科实体	多个
阿尔金山脉 中文名称	其他	单个
鹫峰山脉 长度	数字+单位	单个
鹫峰山脉 著名景点	百科实体	多个
鹫峰山脉 地理位置	其他	句子
鹫峰山脉 外文名	其他	多个
鹫峰山脉 中文名称	其他	单个
龙泉山脉 长度	数字+单位	单个
龙泉山脉 主峰	其他	单个
龙泉山脉 著名景点	百科实体	多个
龙泉山脉 海拔	数字+单位	单个
龙泉山脉 地理位置	其他	句子
龙泉山脉 中文名称	其他	单个
大南山 长度	数字+单位	单个
大南山 主峰	其他	单个
大南山 海拔	数字+单位	单个
大南山 外文名	其他	多个
前黎巴嫩山脉 长度	数字+单位	单个
前黎巴嫩山脉 主峰	其他	单个
前黎巴嫩山脉 著名景点	百科实体	多个
前黎巴嫩山脉 海拔	数字+单位	单个
前黎巴嫩山脉 地理位置	其他	句子
前黎巴嫩山脉 中文名称	其他	单个
南岭 长度	数字+单位	单个
南岭 主峰	其他	单个
南岭 著名景点	百科实体	多个
南岭 海拔	数字+单位	单个
南岭 地理位置	其他	句子
南岭 外文名	其他	多个
南岭 中文名称	其他	单个
黄山 长度	数字+单位	单个
黄山 主峰	其他	单个
阿尔泰山 长度	数字+单位	单个
阿尔泰山 主峰	其他	单个
阿尔泰山 地理位置	其他	句子
大黑山 长度	数字+单位	单个
大黑山 主峰	其他	单个
大黑山 海拔	数字+单位	单个
大黑山 外文名	其他	多个
牛岭山 长度	数字+单位	单个
牛岭山 主峰	其他	单个
牛岭山 著名景点	百科实体	多个
牛岭山 海拔	数字+单位	单个
牛岭山 外文名	其他	多个
鲁文佐里山脉 长度	数字+单位	单个
鲁文佐里山脉 主峰	其他	单个
鲁文佐里山脉 著名景点	百科实体	多个
鲁文佐里山脉 海拔	数字+单位	单个
鲁文佐里山脉 地理位置	其他	句子
鲁文佐里山脉 中文名称	其他	单个
阿拉斯加山脉 长度	数字+单位	单个
阿拉斯加山脉 主峰	其他	单个
阿拉斯加山脉 著名景点	百科实体	多个
大雪山 长度	数字+单位	单个
大雪山 著名景点	百科实体	多个
大雪山 外文名	其他	多个
西高止山脉 长度	数字+单位	单个
西高止山脉 主峰	其他	单个
西高止山脉 著名景点	百科实体	多个
西高止山脉 地理位置	其他	句子
西高止山脉 中文名称	其他	单个
阿特拉斯山脉 长度	数字+单位	单个
阿特拉斯山脉 主峰	其他	单个
阿特拉斯山脉 著名景点	百科实体	多个
阿特拉斯山脉 外文名	其他	多个
大盘山脉 长度	数字+单位	单个
大盘山脉 著名景点	百科实体	多个
大盘山脉 地理位置	其他	句子
大盘山脉 外文名	其他	多个
大盘山脉 中文名称	其他	单个
西马德雷山脉 长度	数字+单位	单个
西马德雷山脉 主峰	其他	单个
西马德雷山脉 著名景点	百科实体	多个
西马德雷山脉 地理位置	其他	句子
西马德雷山脉 外文名	其他	多个
西马德雷山脉 中文名称	其他	单个
比利牛斯山脉 长度	数字+单位	单个
比利牛斯山脉 主峰	其他	单个
比利牛斯山脉 著名景点	百科实体	多个
比利牛斯山脉 海拔	数字+单位	单个
比利牛斯山脉 外文名	其他	多个
兴都库什山脉 长度	数字+单位	单个
兴都库什山脉 著名景点	百科实体	多个
外兴安岭 主峰	其他	单个
外兴安岭 著名景点	百科实体	多个
外兴安岭 外文名	其他	多个
各拉丹冬峰 长度	数字+单位	单个
各拉丹冬峰 主峰	其他	单个
各拉丹冬峰 著名景点	百科实体	多个
各拉丹冬峰 地理位置	其他	句子
各拉丹冬峰 中文名称	其他	单个
九连山脉 长度	数字+单位	单个
九连山脉 著名景点	百科实体	多个
九连山脉 海拔	数字+单位	单个
九连山脉 外文名	其他	多个
九连山脉 中文名称	其他	单个
小兴安岭 主峰	其他	单个
小兴安岭 著名景点	百科实体	多个
小兴安岭 外文名	其他	多个
横贯南极山脉 主峰	其他	单个
横贯南极山脉 著名景点	百科实体	多个
横贯南极山脉 地理位置	其他	句子
横贯南极山脉 中文名称	其他	单个
喀尔巴阡山脉 长度	数字+单位	单个
喀尔巴阡山脉 著名景点	百科实体	多个
喀尔巴阡山脉 海拔	数字+单位	单个
喀尔巴阡山脉 地理位置	其他	句子
喀尔巴阡山脉 中文名称	其他	单个
安第斯山脉 著名景点	百科实体	多个
安第斯山脉 海拔	数字+单位	单个
安第斯山脉 外文名	其他	多个
德拉肯斯堡山脉 长度	数字+单位	单个
德拉肯斯堡山脉 主峰	其他	单个
德拉肯斯堡山脉 著名景点	百科实体	多个
马鬃山 长度	数字+单位	单个
马鬃山 主峰	其他	单个
马鬃山 著名景点	百科实体	多个
马鬃山 海拔	数字+单位	单个
马鬃山 外文名	其他	多个
小相岭 长度	数字+单位	单个
小相岭 主峰	其他	单个
小相岭 著名景点	百科实体	多个
阿尔泰山脉 长度	数字+单位	单个
阿尔泰山脉 主峰	其他	单个
阿尔泰山脉 地理位置	其他	句子
横断山脉 长度	数字+单位	单个
横断山脉 著名景点	百科实体	多个
祁连山脉 长度	数字+单位	单个
祁连山脉 主峰	其他	单个
祁连山脉 著名景点	百科实体	多个
祁连山脉 中文名称	其他	单个
小凉山 长度	数字+单位	单个
小凉山 主峰	其他	单个
小凉山 著名景点	百科实体	多个
小凉山 外文名	其他	多个
大凉山 长度	数字+单位	单个
大凉山 主峰	其他	单个
大凉山 海拔	数字+单位	单个
大凉山 外文名	其他	多个
马尔山脉 长度	数字+单位	单个
马尔山脉 主峰	其他	单个
马尔山脉 著名景点	百科实体	多个
马尔山脉 海拔	数字+单位	单个
马尔山脉 地理位置	其他	句子
马尔山脉 中文名称	其他	单个
日本阿尔卑斯山脉 长度	数字+单位	单个
日本阿尔卑斯山脉 主峰	其他	单个
日本阿尔卑斯山脉 著名景点	百科实体	多个
日本阿尔卑斯山脉 海拔	数字+单位	单个
日本阿尔卑斯山脉 中文名称	其他	单个
海子山 长度	数字+单位	单个
海子山 主峰	其他	单个
怀玉山 长度	数字+单位	单个
怀玉山 主峰	其他	单个
怀玉山 著名景点	百科实体	多个
怀玉山 海拔	数字+单位	单个
怀玉山 地理位置	其他	句子
怀玉山 中文名称	其他	单个
幕阜山脉 长度	数字+单位	单个
幕阜山脉 著名景点	百科实体	多个
幕阜山脉 海拔	数字+单位	单个
幕阜山脉 外文名	其他	多个
戴云山脉 长度	数字+单位	单个
戴云山脉 主峰	其他	单个
戴云山脉 著名景点	百科实体	多个
戴云山脉 地理位置	其他	句子
戴云山脉 外文名	其他	多个
戴云山脉 中文名称	其他	单个
怒山山脉 长度	数字+单位	单个
怒山山脉 著名景点	百科实体	多个
怒山山脉 海拔	数字+单位	单个
怒山山脉 外文名	其他	多个
兴安岭 主峰	其他	单个
兴安岭 著名景点	百科实体	多个
兴安岭 海拔	数字+单位	单个
兴安岭 外文名	其他	多个
六盘山 长度	数字+单位	单个
六盘山 主峰	其他	单个
六盘山 地理位置	其他	句子
六盘山 中文名称	其他	单个
阿尔卑斯山脉 主峰	其他	单个
阿尔卑斯山脉 著名景点	百科实体	多个
阿尔卑斯山脉 中文名称	其他	单个
普陀山 长度	数字+单位	单个
普陀山 主峰	其他	单个
普陀山 海拔	数字+单位	单个
泰山 著名景点	百科实体	多个
泰山 海拔	数字+单位	单个
泰山 外文名	其他	多个
祁连山 主峰	其他	单个
祁连山 著名景点	百科实体	多个
祁连山 海拔	数字+单位	单个
祁连山 外文名	其他	多个
四明山脉 长度	数字+单位	单个
四明山脉 主峰	其他	单个
四明山脉 外文名	其他	多个
乌拉尔山 主峰	其他	单个
乌拉尔山 著名景点	百科实体	多个
乌拉尔山 地理位置	其他	句子
乌拉尔山 中文名称	其他	单个
雀儿山 长度	数字+单位	单个
雀儿山 海拔	数字+单位	单个
雀儿山 外文名	其他	多个
锦屏山 长度	数字+单位	单个
锦屏山 主峰	其他	单个
锦屏山 著名景点	百科实体	多个
锦屏山 海拔	数字+单位	单个
锦屏山 地理位置	其他	句子
锦屏山 外文名	其他	多个
锦屏山 中文名称	其他	单个
松岭山脉 长度	数字+单位	单个
松岭山脉 著名景点	百科实体	多个
松岭山脉 海拔	数字+单位	单个
松岭山脉 地理位置	其他	句子
松岭山脉 外文名	其他	多个
仙霞岭山脉 主峰	其他	单个
仙霞岭山脉 海拔	数字+单位	单个
仙霞岭山脉 外文名	其他	多个
十万大山 著名景点	百科实体	多个
十万大山 外文名	其他	多个
十万大山 中文名称	其他	单个
钦山 长度	数字+单位	单个
钦山 主峰	其他	单个
钦山 著名景点	百科实体	多个
钦山 海拔	数字+单位	单个
钦山 地理位置	其他	句子
钦山 外文名	其他	多个
西高止山 主峰	其他	单个
西高止山 著名景点	百科实体	多个
西高止山 地理位置	其他	句子
西高止山 中文名	其他	单个
西高止山 外文名	其他	多个
西高止山 中文名称	其他	单个
阴山山脉 长度	数字+单位	单个
阴山山脉 主峰	其他	单个
阴山山脉 著名景点	百科实体	多个
阴山山脉 地理位置	其他	句子
阴山山脉 中文名称	其他	单个
斯堪的纳维亚山脉 主峰	其他	单个
斯堪的纳维亚山脉 著名景点	百科实体	多个
斯堪的纳维亚山脉 中文名称	其他	单个
喀喇昆仑山 著名景点	百科实体	多个
喀喇昆仑山 中文名称	其他	单个
喜马拉雅山 长度	数字+单位	单个
喜马拉雅山 著名景点	百科实体	多个
喜马拉雅山 地理位置	其他	句子
喜马拉雅山 中文名称	其他	单个
马更些山脉 长度	数字+单位	单个
马更些山脉 主峰	其他	单个
马更些山脉 著名景点	百科实体	多个
马更些山脉 海拔	数字+单位	单个
马更些山脉 中文名称	其他	单个
龙首山 长度	数字+单位	单个
龙首山 主峰	其他	单个
龙首山 著名景点	百科实体	多个
龙首山 海拔	数字+单位	单个
龙首山 地理位置	其他	句子
龙首山 外文名	其他	多个
大高加索山脉 主峰	其他	单个
大高加索山脉 著名景点	百科实体	多个
大高加索山脉 海拔	数字+单位	单个
大高加索山脉 地理位置	其他	句子
大高加索山脉 中文名称	其他	单个
色尔腾山 长度	数字+单位	单个
色尔腾山 主峰	其他	单个
色尔腾山 著名景点	百科实体	多个
色尔腾山 海拔	数字+单位	单个
色尔腾山 外文名	其他	多个
都庞岭 长度	数字+单位	单个
都庞岭 著名景点	百科实体	多个
都庞岭 海拔	数字+单位	单个
都庞岭 外文名	其他	多个
努鲁儿虎山 长度	数字+单位	单个
努鲁儿虎山 主峰	其他	单个
努鲁儿虎山 著名景点	百科实体	多个
努鲁儿虎山 海拔	数字+单位	单个
努鲁儿虎山 外文名	其他	多个
巴里桑山脉 长度	数字+单位	单个
巴里桑山脉 主峰	其他	单个
巴里桑山脉 著名景点	百科实体	多个
巴里桑山脉 海拔	数字+单位	单个
巴里桑山脉 地理位置	其他	句子
巴里桑山脉 中文名称	其他	单个
邛崃山脉 长度	数字+单位	单个
邛崃山脉 著名景点	百科实体	多个
邛崃山脉 外文名	其他	多个
贺兰山 长度	数字+单位	单个
贺兰山 主峰	其他	单个
贺兰山 中文名称	其他	单个
阿伯德尔山脉 著名景点	百科实体	多个
阿伯德尔山脉 海拔	数字+单位	单个
阿伯德尔山脉 外文名	其他	多个
长白山脉 著名景点	百科实体	多个
长白山脉 海拔	数字+单位	单个
长白山脉 外文名	其他	多个
龙门山脉 长度	数字+单位	单个
龙门山脉 主峰	其他	单个
龙门山脉 外文名	其他	多个
巴塔哥尼亚山脉 长度	数字+单位	单个
巴塔哥尼亚山脉 主峰	其他	单个
巴塔哥尼亚山脉 著名景点	百科实体	多个
巴塔哥尼亚山脉 海拔	数字+单位	单个
巴塔哥尼亚山脉 地理位置	其他	句子
巴塔哥尼亚山脉 外文名	其他	多个
巴塔哥尼亚山脉 中文名称	其他	单个
秦岭山脉 著名景点	百科实体	多个
秦岭山脉 海拔	数字+单位	单个
秦岭山脉 外文名	其他	多个
九岭山脉 长度	数字+单位	单个
九岭山脉 主峰	其他	单个
九岭山脉 著名景点	百科实体	多个
九岭山脉 海拔	数字+单位	单个
九岭山脉 外文名	其他	多个
太岳山脉 长度	数字+单位	单个
太岳山脉 主峰	其他	单个
太岳山脉 著名景点	百科实体	多个
太岳山脉 海拔	数字+单位	单个
太岳山脉 外文名	其他	多个
太岳山脉 中文名称	其他	单个
海岸山脉 长度	数字+单位	单个
海岸山脉 主峰	其他	单个
海岸山脉 著名景点	百科实体	多个
海岸山脉 海拔	数字+单位	单个
亚平宁山脉 长度	数字+单位	单个
亚平宁山脉 主峰	其他	单个
亚平宁山脉 著名景点	百科实体	多个
亚平宁山脉 海拔	数字+单位	单个
亚平宁山脉 外文名	其他	多个
瑶山 长度	数字+单位	单个
瑶山 主峰	其他	单个
瑶山 著名景点	百科实体	多个
瑶山 海拔	数字+单位	单个
瑶山 地理位置	其他	句子
瑶山 外文名	其他	多个
瑶山 中文名称	其他	单个
越城岭 著名景点	百科实体	多个
越城岭 外文名	其他	多个
越城岭 中文名称	其他	单个
卡拉巴略山脉 长度	数字+单位	单个
卡拉巴略山脉 主峰	其他	单个
卡拉巴略山脉 著名景点	百科实体	多个
卡拉巴略山脉 海拔	数字+单位	单个
卡拉巴略山脉 外文名	其他	多个
西倾山 长度	数字+单位	单个
西倾山 主峰	其他	单个
西倾山 著名景点	百科实体	多个
西倾山 海拔	数字+单位	单个
西倾山 外文名	其他	多个
唐古拉山脉 长度	数字+单位	单个
唐古拉山脉 主峰	其他	单个
唐古拉山脉 中文名称	其他	单个
提贝斯提山脉 长度	数字+单位	单个
提贝斯提山脉 主峰	其他	单个
提贝斯提山脉 著名景点	百科实体	多个
提贝斯提山脉 海拔	数字+单位	单个
提贝斯提山脉 地理位置	其他	句子
提贝斯提山脉 外文名	其他	多个
提贝斯提山脉 中文名称	其他	单个
大苗山 长度	数字+单位	单个
大苗山 主峰	其他	单个
大苗山 著名景点	百科实体	多个
大苗山 海拔	数字+单位	单个
大苗山 地理位置	其他	句子
大苗山 外文名	其他	多个
大苗山 中文名称	其他	单个
雪山山脉 主峰	其他	单个
雪山山脉 著名景点	百科实体	多个
雪山山脉 海拔	数字+单位	单个
雪山山脉 中文名称	其他	单个
博平岭山脉 长度	数字+单位	单个
博平岭山脉 主峰	其他	单个
博平岭山脉 著名景点	百科实体	多个
博平岭山脉 外文名	其他	多个
乔戈里峰 长度	数字+单位	单个
乔戈里峰 主峰	其他	单个
乔戈里峰 著名景点	百科实体	多个
乔戈里峰 海拔	数字+单位	单个
南马德雷山脉 长度	数字+单位	单个
南马德雷山脉 主峰	其他	单个
南马德雷山脉 著名景点	百科实体	多个
南马德雷山脉 地理位置	其他	句子
南马德雷山脉 中文名称	其他	单个
科迪勒拉山脉 长度	数字+单位	单个
科迪勒拉山脉 主峰	其他	单个
科迪勒拉山脉 著名景点	百科实体	多个
科迪勒拉山脉 地理位置	其他	句子
科迪勒拉山脉 外文名	其他	多个
科迪勒拉山脉 中文名称	其他	单个
崤山 主峰	其他	单个
崤山 海拔	数字+单位	单个
宁镇山脉 主峰	其他	单个
宁镇山脉 著名景点	百科实体	多个
宁镇山脉 海拔	数字+单位	单个
宁镇山脉 地理位置	其他	句子
宁镇山脉 中文名称	其他	单个
天山山脉 著名景点	百科实体	多个
天山山脉 海拔	数字+单位	单个
天山山脉 外文名	其他	多个
吊罗山 长度	数字+单位	单个
吊罗山 主峰	其他	单个
吊罗山 海拔	数字+单位	单个
燕山山脉 长度	数字+单位	单个
燕山山脉 主峰	其他	单个
燕山山脉 著名景点	百科实体	多个
燕山山脉 地理位置	其他	句子
燕山山脉 中文名称	其他	单个
念青唐古拉山 长度	数字+单位	单个
念青唐古拉山 主峰	其他	单个
念青唐古拉山 著名景点	百科实体	多个
念青唐古拉山 中文名称	其他	单个
扎格罗斯山脉 长度	数字+单位	单个
扎格罗斯山脉 主峰	其他	单个
扎格罗斯山脉 著名景点	百科实体	多个
扎格罗斯山脉 地理位置	其他	句子
扎格罗斯山脉 中文名称	其他	单个
萨彦岭 长度	数字+单位	单个
萨彦岭 主峰	其他	单个
萨彦岭 著名景点	百科实体	多个
萨彦岭 海拔	数字+单位	单个
海洋山 长度	数字+单位	单个
海洋山 著名景点	百科实体	多个
海洋山 外文名	其他	多个
海洋山 中文名称	其他	单个
南阿尔卑斯山脉 长度	数字+单位	单个
南阿尔卑斯山脉 主峰	其他	单个
南阿尔卑斯山脉 著名景点	百科实体	多个
南阿尔卑斯山脉 海拔	数字+单位	单个
南阿尔卑斯山脉 地理位置	其他	句子
南阿尔卑斯山脉 中文名称	其他	单个
武陵山脉 长度	数字+单位	单个
武陵山脉 著名景点	百科实体	多个
武陵山脉 外文名	其他	多个
大巴山脉 长度	数字+单位	单个
大巴山脉 主峰	其他	单个
大巴山脉 著名景点	百科实体	多个
大巴山脉 海拔	数字+单位	单个
大巴山脉 地理位置	其他	句子
大巴山脉 中文名称	其他	单个
六万大山 长度	数字+单位	单个
六万大山 主峰	其他	单个
六万大山 著名景点	百科实体	多个
六万大山 海拔	数字+单位	单个
六万大山 外文名	其他	多个
夹金山 长度	数字+单位	单个
夹金山 主峰	其他	单个
夹金山 海拔	数字+单位	单个
夹金山 外文名	其他	多个
穆钦加山脉 著名景点	百科实体	多个
穆钦加山脉 外文名	其他	多个
奔宁山脉 长度	数字+单位	单个
奔宁山脉 主峰	其他	单个
奔宁山脉 著名景点	百科实体	多个
奔宁山脉 海拔	数字+单位	单个
维龙加山脉 长度	数字+单位	单个
维龙加山脉 著名景点	百科实体	多个
维龙加山脉 海拔	数字+单位	单个
维龙加山脉 外文名	其他	多个
云开大山 著名景点	百科实体	多个
云开大山 外文名	其他	多个
澳大利亚山脉 长度	数字+单位	单个
澳大利亚山脉 主峰	其他	单个
澳大利亚山脉 著名景点	百科实体	多个
澳大利亚山脉 海拔	数字+单位	单个
澳大利亚山脉 地理位置	其他	句子
澳大利亚山脉 外文名	其他	多个
澳大利亚山脉 中文名称	其他	单个
牛头山 长度	数字+单位	单个
牛头山 主峰	其他	单个
牛头山 著名景点	百科实体	多个
牛头山 海拔	数字+单位	单个
牛头山 外文名	其他	多个
米通巴山脉 长度	数字+单位	单个
米通巴山脉 主峰	其他	单个
米通巴山脉 著名景点	百科实体	多个
米通巴山脉 地理位置	其他	句子
米通巴山脉 外文名	其他	多个
米通巴山脉 中文名称	其他	单个
云台山 长度	数字+单位	单个
云台山 主峰	其他	单个
云台山 海拔	数字+单位	单个
莲花山脉 长度	数字+单位	单个
莲花山脉 著名景点	百科实体	多个
莲花山脉 外文名	其他	多个
莲花山脉 中文名称	其他	单个
华山 外文名	其他	多个
庐山 海拔	数字+单位	单个
庐山 外文名	其他	多个
高加索山脉 长度	数字+单位	单个
高加索山脉 主峰	其他	单个
高加索山脉 著名景点	百科实体	多个
高加索山脉 地理位置	其他	句子
高加索山脉 中文名称	其他	单个
香山 长度	数字+单位	单个
香山 主峰	其他	单个
香山 海拔	数字+单位	单个
马德雷山系 长度	数字+单位	单个
马德雷山系 主峰	其他	单个
马德雷山系 著名景点	百科实体	多个
马德雷山系 海拔	数字+单位	单个
马德雷山系 地理位置	其他	句子
马德雷山系 外文名	其他	多个
五指山 长度	数字+单位	单个
五指山 主峰	其他	单个
五指山 海拔	数字+单位	单个
大兴安岭 外文名	其他	多个
伏牛山 长度	数字+单位	单个
伏牛山 主峰	其他	单个
伏牛山 地理位置	其他	句子
伏牛山 中文名称	其他	单个
科迪勒拉山系 主峰	其他	单个
科迪勒拉山系 著名景点	百科实体	多个
科迪勒拉山系 海拔	数字+单位	单个
科迪勒拉山系 中文名称	其他	单个
罗山 长度	数字+单位	单个
罗山 主峰	其他	单个
罗山 海拔	数字+单位	单个
牛首山 长度	数字+单位	单个
牛首山 主峰	其他	单个
牛首山 外文名	其他	多个
蒂迪旺沙山脉 长度	数字+单位	单个
蒂迪旺沙山脉 主峰	其他	单个
蒂迪旺沙山脉 著名景点	百科实体	多个
蒂迪旺沙山脉 海拔	数字+单位	单个
蒂迪旺沙山脉 地理位置	其他	句子
蒂迪旺沙山脉 中文名称	其他	单个
哈默斯利岭 长度	数字+单位	单个
哈默斯利岭 主峰	其他	单个
哈默斯利岭 著名景点	百科实体	多个
哈默斯利岭 海拔	数字+单位	单个
哈默斯利岭 地理位置	其他	句子
哈默斯利岭 中文名称	其他	单个
雁荡山脉 长度	数字+单位	单个
雁荡山脉 海拔	数字+单位	单个
雁荡山脉 外文名	其他	多个
中央山脉 著名景点	百科实体	多个
中央山脉 海拔	数字+单位	单个
中央山脉 外文名	其他	多个
云雾山脉 长度	数字+单位	单个
云雾山脉 主峰	其他	单个
云雾山脉 著名景点	百科实体	多个
兴都库什山 长度	数字+单位	单个
兴都库什山 主峰	其他	单个
兴都库什山 著名景点	百科实体	多个
兴都库什山 中文名称	其他	单个
