福建省 著名高校	地名	多个
福建省 省会	地名	单个
西藏自治区 GDP	数字+单位	单个
西藏自治区 著名高校	地名	多个
西藏自治区 人均GDP	数字+单位	单个
西藏自治区 省会	地名	单个
西藏自治区 省委书记	人名	单个
西藏自治区 人类发展指数	数字	单个
西藏自治区 省长	人名	单个
贵州省 地区生产总值	数字+单位	单个
贵州省 著名高校	地名	多个
贵州省 历史名人	人名	多个
贵州省 邮政区码	数字	单个
湖北省 GDP	数字+单位	单个
湖北省 地区生产总值	数字+单位	单个
湖北省 著名高校	地名	多个
湖北省 人均GDP	数字+单位	单个
湖北省 省会	地名	单个
湖北省 历史名人	人名	多个
湖北省 省委书记	人名	单个
湖北省 人类发展指数	数字	单个
湖北省 省长	人名	单个
湖南省 GDP	数字+单位	单个
湖南省 人均GDP	数字+单位	单个
湖南省 省会	地名	单个
湖南省 人类发展指数	数字	单个
广东省 GDP	数字+单位	单个
广东省 著名高校	地名	多个
广东省 人均GDP	数字+单位	单个
广东省 省会	地名	单个
广东省 历史名人	人名	多个
广东省 人类发展指数	数字	单个
澳门特别行政区 GDP	数字+单位	单个
澳门特别行政区 人均GDP	数字+单位	单个
澳门特别行政区 省会	地名	单个
澳门特别行政区 历史名人	人名	多个
澳门特别行政区 省委书记	人名	单个
澳门特别行政区 省长	人名	单个
香港特别行政区 GDP	数字+单位	单个
香港特别行政区 著名高校	地名	多个
香港特别行政区 人均GDP	数字+单位	单个
香港特别行政区 省会	地名	单个
香港特别行政区 历史名人	人名	多个
香港特别行政区 省委书记	人名	单个
香港特别行政区 省长	人名	单个
四川省 地区生产总值	数字+单位	单个
四川省 著名高校	地名	多个
四川省 省会	地名	单个
四川省 省委书记	人名	单个
四川省 人类发展指数	数字	单个
四川省 省长	人名	单个
安徽省 人类发展指数	数字	单个
新疆维吾尔自治区 GDP	数字+单位	单个
新疆维吾尔自治区 著名高校	地名	多个
新疆维吾尔自治区 人均GDP	数字+单位	单个
新疆维吾尔自治区 省会	地名	单个
新疆维吾尔自治区 历史名人	人名	多个
新疆维吾尔自治区 省委书记	人名	单个
新疆维吾尔自治区 省长	人名	单个
江苏省 地区生产总值	数字+单位	单个
江苏省 省会	地名	单个
江苏省 人类发展指数	数字	单个
吉林省 地区生产总值	数字+单位	单个
吉林省 著名高校	地名	多个
吉林省 历史名人	人名	多个
吉林省 省委书记	人名	单个
吉林省 人类发展指数	数字	单个
吉林省 省长	人名	单个
宁夏回族自治区 GDP	数字+单位	单个
宁夏回族自治区 地区生产总值	数字+单位	单个
宁夏回族自治区 著名高校	地名	多个
宁夏回族自治区 人均GDP	数字+单位	单个
宁夏回族自治区 省会	地名	单个
宁夏回族自治区 历史名人	人名	多个
宁夏回族自治区 省委书记	人名	单个
宁夏回族自治区 省长	人名	单个
河南省 地区生产总值	数字+单位	单个
河南省 著名高校	地名	多个
河南省 省委书记	人名	单个
河南省 人类发展指数	数字	单个
河南省 省长	人名	单个
河北省 GDP	数字+单位	单个
河北省 人均GDP	数字+单位	单个
河北省 历史名人	人名	多个
河北省 人类发展指数	数字	单个
广西壮族自治区 地区生产总值	数字+单位	单个
广西壮族自治区 著名高校	地名	多个
广西壮族自治区 人均GDP	数字+单位	单个
广西壮族自治区 省会	地名	单个
广西壮族自治区 历史名人	人名	多个
广西壮族自治区 省委书记	人名	单个
广西壮族自治区 人类发展指数	数字	单个
广西壮族自治区 省长	人名	单个
海南省 GDP	数字+单位	单个
海南省 著名高校	地名	多个
海南省 人均GDP	数字+单位	单个
海南省 历史名人	人名	多个
海南省 人类发展指数	数字	单个
江西省 著名高校	地名	多个
江西省 省会	地名	单个
江西省 历史名人	人名	多个
江西省 省委书记	人名	单个
江西省 人类发展指数	数字	单个
江西省 省长	人名	单个
云南省 GDP	数字+单位	单个
云南省 地区生产总值	数字+单位	单个
云南省 人均GDP	数字+单位	单个
云南省 历史名人	人名	多个
甘肃省 GDP	数字+单位	单个
甘肃省 地区生产总值	数字+单位	单个
甘肃省 著名高校	地名	多个
甘肃省 人均GDP	数字+单位	单个
甘肃省 省会	地名	单个
甘肃省 历史名人	人名	多个
山东省 地区生产总值	数字+单位	单个
山东省 著名高校	地名	多个
山东省 省会	地名	单个
山东省 历史名人	人名	多个
山东省 人类发展指数	数字	单个
陕西省 GDP	数字+单位	单个
陕西省 地区生产总值	数字+单位	单个
陕西省 著名高校	地名	多个
陕西省 人均GDP	数字+单位	单个
陕西省 省会	地名	单个
陕西省 历史名人	人名	多个
陕西省 邮政区码	数字	单个
浙江省 地区生产总值	数字+单位	单个
浙江省 著名高校	地名	多个
浙江省 人类发展指数	数字	单个
内蒙古自治区 GDP	数字+单位	单个
内蒙古自治区 著名高校	地名	多个
内蒙古自治区 人均GDP	数字+单位	单个
内蒙古自治区 省会	地名	单个
内蒙古自治区 历史名人	人名	多个
内蒙古自治区 省委书记	人名	单个
内蒙古自治区 人类发展指数	数字	单个
内蒙古自治区 省长	人名	单个
青海省 GDP	数字+单位	单个
青海省 著名高校	地名	多个
青海省 人均GDP	数字+单位	单个
青海省 省会	地名	单个
青海省 历史名人	人名	多个
青海省 省长	人名	单个
辽宁省 GDP	数字+单位	单个
辽宁省 人均GDP	数字+单位	单个
辽宁省 省会	地名	单个
辽宁省 历史名人	人名	多个
辽宁省 省委书记	人名	单个
辽宁省 人类发展指数	数字	单个
台湾省 地区生产总值	数字+单位	单个
台湾省 著名高校	地名	多个
台湾省 省会	地名	单个
台湾省 车牌代码	其他	句子
台湾省 历史名人	人名	多个
台湾省 省委书记	人名	单个
台湾省 邮政区码	数字	单个
台湾省 省长	人名	单个
黑龙江省 GDP	数字+单位	单个
黑龙江省 著名高校	地名	多个
黑龙江省 人均GDP	数字+单位	单个
黑龙江省 省会	地名	单个
黑龙江省 历史名人	人名	多个
山西省 GDP	数字+单位	单个
山西省 地区生产总值	数字+单位	单个
山西省 著名高校	地名	多个
山西省 人均GDP	数字+单位	单个
山西省 省会	地名	单个
山西省 历史名人	人名	多个
山西省 省委书记	人名	单个
山西省 人类发展指数	数字	单个
山西省 省长	人名	单个
