湟川三峡 所属城市	其他	句子
湟川三峡 著名景点	其他	单个
湟川三峡 景点级别	其他	单个
湟川三峡 中文名称	其他	句子
湟川三峡 所属国家	其他	单个
永定河峡谷 所属城市	其他	句子
永定河峡谷 著名景点	其他	单个
永定河峡谷 地理位置	其他	句子
永定河峡谷 景点级别	其他	单个
永定河峡谷 门票价格	数字+单位	单个
永定河峡谷 中文名称	其他	句子
永定河峡谷 所属国家	其他	单个
粤北大峡谷 所属城市	其他	句子
粤北大峡谷 著名景点	其他	单个
粤北大峡谷 开放时间	数字+单位	单个
粤北大峡谷 地理位置	其他	句子
粤北大峡谷 景点级别	其他	单个
粤北大峡谷 门票价格	数字+单位	单个
粤北大峡谷 所属国家	其他	单个
库车大峡谷 所属城市	其他	句子
库车大峡谷 著名景点	其他	单个
库车大峡谷 开放时间	数字+单位	单个
库车大峡谷 所属国家	其他	单个
大渡河峡谷 所属城市	其他	句子
大渡河峡谷 著名景点	其他	单个
大渡河峡谷 开放时间	数字+单位	单个
大渡河峡谷 景点级别	其他	单个
大渡河峡谷 门票价格	数字+单位	单个
大渡河峡谷 所属国家	其他	单个
华蓥山大峡谷 所属城市	其他	句子
华蓥山大峡谷 著名景点	其他	单个
华蓥山大峡谷 开放时间	数字+单位	单个
华蓥山大峡谷 地理位置	其他	句子
华蓥山大峡谷 景点级别	其他	单个
华蓥山大峡谷 门票价格	数字+单位	单个
华蓥山大峡谷 中文名称	其他	句子
华蓥山大峡谷 所属国家	其他	单个
武陵岩峡谷 所属城市	其他	句子
武陵岩峡谷 开放时间	数字+单位	单个
武陵岩峡谷 景点级别	其他	单个
武陵岩峡谷 门票价格	数字+单位	单个
武陵岩峡谷 所属国家	其他	单个
古龙山峡谷 所属城市	其他	句子
古龙山峡谷 开放时间	数字+单位	单个
古龙山峡谷 地理位置	其他	句子
古龙山峡谷 景点级别	其他	单个
古龙山峡谷 所属国家	其他	单个
王莽峡 所属城市	其他	句子
王莽峡 开放时间	数字+单位	单个
王莽峡 门票价格	数字+单位	单个
王莽峡 所属国家	其他	单个
洛吉河峡谷 所属城市	其他	句子
洛吉河峡谷 著名景点	其他	单个
洛吉河峡谷 开放时间	数字+单位	单个
洛吉河峡谷 地理位置	其他	句子
洛吉河峡谷 景点级别	其他	单个
洛吉河峡谷 门票价格	数字+单位	单个
洛吉河峡谷 中文名称	其他	句子
洛吉河峡谷 所属国家	其他	单个
花江峡谷 所属城市	其他	句子
花江峡谷 开放时间	数字+单位	单个
花江峡谷 景点级别	其他	单个
花江峡谷 门票价格	数字+单位	单个
花江峡谷 所属国家	其他	单个
纳摩峡谷 所属城市	其他	句子
纳摩峡谷 景点级别	其他	单个
纳摩峡谷 门票价格	数字+单位	单个
纳摩峡谷 所属国家	其他	单个
马岭河峡谷 所属城市	其他	句子
马岭河峡谷 景点级别	其他	单个
马岭河峡谷 中文名称	其他	句子
马岭河峡谷 所属国家	其他	单个
靖西通灵大峡谷 所属城市	其他	句子
靖西通灵大峡谷 著名景点	其他	单个
靖西通灵大峡谷 开放时间	数字+单位	单个
靖西通灵大峡谷 地理位置	其他	句子
靖西通灵大峡谷 景点级别	其他	单个
靖西通灵大峡谷 门票价格	数字+单位	单个
靖西通灵大峡谷 中文名称	其他	句子
靖西通灵大峡谷 所属国家	其他	单个
洋泗峡谷 所属城市	其他	句子
洋泗峡谷 著名景点	其他	单个
洋泗峡谷 开放时间	数字+单位	单个
洋泗峡谷 地理位置	其他	句子
洋泗峡谷 景点级别	其他	单个
洋泗峡谷 门票价格	数字+单位	单个
洋泗峡谷 中文名称	其他	句子
洋泗峡谷 所属国家	其他	单个
雅鲁藏布大峡谷 地理位置	其他	句子
雅鲁藏布大峡谷 中文名称	其他	句子
怒江大峡谷 著名景点	其他	单个
怒江大峡谷 开放时间	数字+单位	单个
怒江大峡谷 地理位置	其他	句子
怒江大峡谷 景点级别	其他	单个
怒江大峡谷 中文名称	其他	句子
金丝大峡谷 开放时间	数字+单位	单个
八泉峡 所属城市	其他	句子
八泉峡 著名景点	其他	单个
八泉峡 开放时间	数字+单位	单个
八泉峡 景点级别	其他	单个
八泉峡 门票价格	数字+单位	单个
八泉峡 所属国家	其他	单个
晋陕大峡谷 著名景点	其他	单个
晋陕大峡谷 开放时间	数字+单位	单个
晋陕大峡谷 景点级别	其他	单个
晋陕大峡谷 门票价格	数字+单位	单个
碧融峡谷 所属城市	其他	句子
碧融峡谷 开放时间	数字+单位	单个
碧融峡谷 景点级别	其他	单个
碧融峡谷 门票价格	数字+单位	单个
碧融峡谷 所属国家	其他	单个
太鲁阁峡谷 景点级别	其他	单个
碧壤峡谷 所属城市	其他	句子
碧壤峡谷 著名景点	其他	单个
碧壤峡谷 开放时间	数字+单位	单个
碧壤峡谷 景点级别	其他	单个
碧壤峡谷 门票价格	数字+单位	单个
碧壤峡谷 所属国家	其他	单个
五须海峡谷 所属城市	其他	句子
五须海峡谷 著名景点	其他	单个
五须海峡谷 开放时间	数字+单位	单个
五须海峡谷 景点级别	其他	单个
五须海峡谷 所属国家	其他	单个
瑶山峡谷 所属城市	其他	句子
瑶山峡谷 开放时间	数字+单位	单个
瑶山峡谷 景点级别	其他	单个
瑶山峡谷 门票价格	数字+单位	单个
瑶山峡谷 所属国家	其他	单个
梅里大峡谷 所属城市	其他	句子
梅里大峡谷 著名景点	其他	单个
梅里大峡谷 开放时间	数字+单位	单个
梅里大峡谷 景点级别	其他	单个
梅里大峡谷 门票价格	数字+单位	单个
梅里大峡谷 所属国家	其他	单个
双桥沟峡谷 所属城市	其他	句子
双桥沟峡谷 著名景点	其他	单个
双桥沟峡谷 开放时间	数字+单位	单个
双桥沟峡谷 地理位置	其他	句子
双桥沟峡谷 景点级别	其他	单个
双桥沟峡谷 门票价格	数字+单位	单个
双桥沟峡谷 中文名称	其他	句子
双桥沟峡谷 所属国家	其他	单个
长江三峡 所属城市	其他	句子
长江三峡 所属国家	其他	单个
红河谷 所属城市	其他	句子
红河谷 著名景点	其他	单个
红河谷 开放时间	数字+单位	单个
红河谷 地理位置	其他	句子
红河谷 景点级别	其他	单个
红河谷 门票价格	数字+单位	单个
红河谷 中文名称	其他	句子
红河谷 所属国家	其他	单个
暖东峡谷 所属城市	其他	句子
暖东峡谷 开放时间	数字+单位	单个
暖东峡谷 景点级别	其他	单个
暖东峡谷 门票价格	数字+单位	单个
暖东峡谷 所属国家	其他	单个
青龙峡 地理位置	其他	句子
青龙峡 景点级别	其他	单个
太行山龙泉峡 所属城市	其他	句子
太行山龙泉峡 著名景点	其他	单个
太行山龙泉峡 开放时间	数字+单位	单个
太行山龙泉峡 门票价格	数字+单位	单个
太行山龙泉峡 所属国家	其他	单个
鄣山大峡谷 所属城市	其他	句子
鄣山大峡谷 所属国家	其他	单个
纸棚河峡谷 所属城市	其他	句子
纸棚河峡谷 著名景点	其他	单个
纸棚河峡谷 开放时间	数字+单位	单个
纸棚河峡谷 景点级别	其他	单个
纸棚河峡谷 门票价格	数字+单位	单个
纸棚河峡谷 所属国家	其他	单个
达娜伊谷 所属城市	其他	句子
达娜伊谷 著名景点	其他	单个
达娜伊谷 开放时间	数字+单位	单个
达娜伊谷 景点级别	其他	单个
达娜伊谷 门票价格	数字+单位	单个
达娜伊谷 所属国家	其他	单个
青山尾峡谷 所属城市	其他	句子
青山尾峡谷 开放时间	数字+单位	单个
青山尾峡谷 景点级别	其他	单个
青山尾峡谷 门票价格	数字+单位	单个
青山尾峡谷 所属国家	其他	单个
五指峡 所属城市	其他	句子
五指峡 著名景点	其他	单个
五指峡 开放时间	数字+单位	单个
五指峡 景点级别	其他	单个
五指峡 门票价格	数字+单位	单个
五指峡 中文名称	其他	句子
五指峡 所属国家	其他	单个
六广河峡谷 所属城市	其他	句子
六广河峡谷 著名景点	其他	单个
六广河峡谷 开放时间	数字+单位	单个
六广河峡谷 地理位置	其他	句子
六广河峡谷 景点级别	其他	单个
六广河峡谷 门票价格	数字+单位	单个
六广河峡谷 中文名称	其他	句子
六广河峡谷 所属国家	其他	单个
