北赤道暖流 流速	数字+单位	单个
西风漂流 流速	数字+单位	单个
西风漂流 类型	其他	句子
秘鲁寒流 外文名	百科实体	多个
秘鲁寒流 流速	数字+单位	单个
秘鲁寒流 类型	其他	句子
墨西哥暖流 流速	数字+单位	单个
墨西哥暖流 类型	其他	句子
千岛寒流 流速	数字+单位	单个
千岛寒流 类型	其他	句子
本格拉寒流 外文名	百科实体	多个
巴西暖流 流速	数字+单位	单个
巴西暖流 类型	其他	句子
日本暖流 外文名	百科实体	多个
日本暖流 流速	数字+单位	单个
日本暖流 类型	其他	句子
北大西洋暖流 流速	数字+单位	单个
北大西洋暖流 类型	其他	句子
东澳大利亚暖流 外文名	百科实体	多个
东澳大利亚暖流 流速	数字+单位	单个
北太平洋暖流 外文名	百科实体	多个
北太平洋暖流 流速	数字+单位	单个
北太平洋暖流 类型	其他	句子
马达加斯加暖流 外文名	百科实体	多个
马达加斯加暖流 类型	其他	句子
阿拉斯加暖流 外文名	百科实体	多个
阿拉斯加暖流 类型	其他	句子
