雁鸣湖国家级自然保护区 景点级别	其他	单个
雁鸣湖国家级自然保护区 占地面积	数字+单位	单个
雁鸣湖国家级自然保护区 气候类型	其他	句子
雁鸣湖国家级自然保护区 批准时间	数字+单位	单个
雁鸣湖国家级自然保护区 中文名称	其他	句子
蜂桶寨国家级自然保护区 地理位置	其他	句子
蜂桶寨国家级自然保护区 景点级别	其他	单个
蜂桶寨国家级自然保护区 占地面积	数字+单位	单个
蜂桶寨国家级自然保护区 气候类型	其他	句子
蜂桶寨国家级自然保护区 中文名称	其他	句子
泥河湾国家级自然保护区 景点级别	其他	单个
泥河湾国家级自然保护区 类型	其他	句子
泥河湾国家级自然保护区 气候	其他	句子
泥河湾国家级自然保护区 占地面积	数字+单位	单个
泥河湾国家级自然保护区 保护对象	其他	句子
泥河湾国家级自然保护区 气候类型	其他	句子
泥河湾国家级自然保护区 批准时间	数字+单位	单个
泥河湾国家级自然保护区 中文名称	其他	句子
阿鲁科尔沁草原国家级自然保护区 类型	其他	句子
阿鲁科尔沁草原国家级自然保护区 气候	其他	句子
阿鲁科尔沁草原国家级自然保护区 保护对象	其他	句子
阿鲁科尔沁草原国家级自然保护区 气候类型	其他	句子
阿鲁科尔沁草原国家级自然保护区 批准时间	数字+单位	单个
北票鸟化石国家级自然保护区 景点级别	其他	单个
北票鸟化石国家级自然保护区 占地面积	数字+单位	单个
北票鸟化石国家级自然保护区 气候类型	其他	句子
马山国家级自然保护区 保护对象	其他	句子
马山国家级自然保护区 批准时间	数字+单位	单个
大明山国家级自然保护区 景点级别	其他	单个
大明山国家级自然保护区 批准时间	数字+单位	单个
张家界大鲵国家级自然保护区 批准时间	数字+单位	单个
大青沟国家级自然保护区 景点级别	其他	单个
大青沟国家级自然保护区 气候	其他	句子
大青沟国家级自然保护区 占地面积	数字+单位	单个
大青沟国家级自然保护区 气候类型	其他	句子
大青沟国家级自然保护区 批准时间	数字+单位	单个
大青沟国家级自然保护区 中文名称	其他	句子
柳江盆地地质遗迹国家级自然保护区 景点级别	其他	单个
柳江盆地地质遗迹国家级自然保护区 占地面积	数字+单位	单个
柳江盆地地质遗迹国家级自然保护区 气候类型	其他	句子
柳江盆地地质遗迹国家级自然保护区 中文名称	其他	句子
小溪国家级自然保护区 保护对象	其他	句子
小溪国家级自然保护区 批准时间	数字+单位	单个
辽宁努鲁儿虎山国家级自然保护区 景点级别	其他	单个
辽宁努鲁儿虎山国家级自然保护区 气候	其他	句子
辽宁努鲁儿虎山国家级自然保护区 占地面积	数字+单位	单个
辽宁努鲁儿虎山国家级自然保护区 气候类型	其他	句子
辽宁努鲁儿虎山国家级自然保护区 批准时间	数字+单位	单个
辽宁努鲁儿虎山国家级自然保护区 中文名称	其他	句子
文山国家级自然保护区 地理位置	其他	句子
文山国家级自然保护区 景点级别	其他	单个
文山国家级自然保护区 气候	其他	句子
文山国家级自然保护区 占地面积	数字+单位	单个
文山国家级自然保护区 气候类型	其他	句子
文山国家级自然保护区 中文名称	其他	句子
八仙山国家级自然保护区 景点级别	其他	单个
八仙山国家级自然保护区 级别	其他	单个
八仙山国家级自然保护区 批准时间	数字+单位	单个
凉水国家级自然保护区 地理位置	其他	句子
凉水国家级自然保护区 景点级别	其他	单个
凉水国家级自然保护区 级别	其他	单个
凉水国家级自然保护区 气候	其他	句子
凉水国家级自然保护区 占地面积	数字+单位	单个
凉水国家级自然保护区 气候类型	其他	句子
凉水国家级自然保护区 批准时间	数字+单位	单个
凉水国家级自然保护区 中文名称	其他	句子
贺兰山国家级自然保护区 景点级别	其他	单个
贺兰山国家级自然保护区 类型	其他	句子
贺兰山国家级自然保护区 占地面积	数字+单位	单个
贺兰山国家级自然保护区 保护对象	其他	句子
贺兰山国家级自然保护区 气候类型	其他	句子
羌塘国家级自然保护区 地理位置	其他	句子
羌塘国家级自然保护区 景点级别	其他	单个
羌塘国家级自然保护区 类型	其他	句子
羌塘国家级自然保护区 气候	其他	句子
羌塘国家级自然保护区 占地面积	数字+单位	单个
羌塘国家级自然保护区 气候类型	其他	句子
羌塘国家级自然保护区 批准时间	数字+单位	单个
羌塘国家级自然保护区 中文名称	其他	句子
浙江象山韭山列岛海洋生态国家级自然保护区 景点级别	其他	单个
浙江象山韭山列岛海洋生态国家级自然保护区 占地面积	数字+单位	单个
浙江象山韭山列岛海洋生态国家级自然保护区 气候类型	其他	句子
大黑山国家级自然保护区 地理位置	其他	句子
大黑山国家级自然保护区 景点级别	其他	单个
大黑山国家级自然保护区 气候	其他	句子
大黑山国家级自然保护区 占地面积	数字+单位	单个
大黑山国家级自然保护区 气候类型	其他	句子
大黑山国家级自然保护区 批准时间	数字+单位	单个
大黑山国家级自然保护区 中文名称	其他	句子
长宁竹海国家级自然保护区 地理位置	其他	句子
长宁竹海国家级自然保护区 景点级别	其他	单个
长宁竹海国家级自然保护区 级别	其他	单个
长宁竹海国家级自然保护区 占地面积	数字+单位	单个
长宁竹海国家级自然保护区 气候类型	其他	句子
长宁竹海国家级自然保护区 批准时间	数字+单位	单个
长宁竹海国家级自然保护区 中文名称	其他	句子
九万山国家级自然保护区 景点级别	其他	单个
白音熬包国家级自然保护区 景点级别	其他	单个
白音熬包国家级自然保护区 占地面积	数字+单位	单个
白音熬包国家级自然保护区 气候类型	其他	句子
饶河东北黑蜂国家级自然保护区 批准时间	数字+单位	单个
阿尔金山国家级自然保护区 地理位置	其他	句子
阿尔金山国家级自然保护区 景点级别	其他	单个
阿尔金山国家级自然保护区 中文名	其他	句子
阿尔金山国家级自然保护区 气候	其他	句子
阿尔金山国家级自然保护区 占地面积	数字+单位	单个
阿尔金山国家级自然保护区 保护对象	其他	句子
阿尔金山国家级自然保护区 气候类型	其他	句子
阿尔金山国家级自然保护区 批准时间	数字+单位	单个
阿尔金山国家级自然保护区 中文名称	其他	句子
三亚珊瑚礁国家级自然保护区 保护对象	其他	句子
三亚珊瑚礁国家级自然保护区 批准时间	数字+单位	单个
赤水桫椤国家级自然保护区 景点级别	其他	单个
赤水桫椤国家级自然保护区 批准时间	数字+单位	单个
牛背梁国家级自然保护区 保护对象	其他	句子
牛背梁国家级自然保护区 批准时间	数字+单位	单个
兴凯湖国家级自然保护区 地理位置	其他	句子
兴凯湖国家级自然保护区 景点级别	其他	单个
兴凯湖国家级自然保护区 类型	其他	句子
兴凯湖国家级自然保护区 气候	其他	句子
兴凯湖国家级自然保护区 占地面积	数字+单位	单个
兴凯湖国家级自然保护区 气候类型	其他	句子
兴凯湖国家级自然保护区 批准时间	数字+单位	单个
兴凯湖国家级自然保护区 中文名称	其他	句子
湛江红树林国家级自然保护区 景点级别	其他	单个
湛江红树林国家级自然保护区 类型	其他	句子
湛江红树林国家级自然保护区 占地面积	数字+单位	单个
湛江红树林国家级自然保护区 气候类型	其他	句子
湛江红树林国家级自然保护区 批准时间	数字+单位	单个
额济纳胡杨林国家级自然保护区 景点级别	其他	单个
额济纳胡杨林国家级自然保护区 级别	其他	单个
额济纳胡杨林国家级自然保护区 气候	其他	句子
额济纳胡杨林国家级自然保护区 占地面积	数字+单位	单个
额济纳胡杨林国家级自然保护区 气候类型	其他	句子
额济纳胡杨林国家级自然保护区 批准时间	数字+单位	单个
额济纳胡杨林国家级自然保护区 中文名称	其他	句子
清凉峰国家级自然保护区 景点级别	其他	单个
清凉峰国家级自然保护区 级别	其他	单个
清凉峰国家级自然保护区 类型	其他	句子
清凉峰国家级自然保护区 气候	其他	句子
清凉峰国家级自然保护区 占地面积	数字+单位	单个
清凉峰国家级自然保护区 保护对象	其他	句子
清凉峰国家级自然保护区 气候类型	其他	句子
清凉峰国家级自然保护区 批准时间	数字+单位	单个
辽宁白石砬子国家级自然保护区 景点级别	其他	单个
辽宁白石砬子国家级自然保护区 批准时间	数字+单位	单个
九龙山国家级自然保护区 景点级别	其他	单个
九龙山国家级自然保护区 批准时间	数字+单位	单个
南瓮河国家级自然保护区 地理位置	其他	句子
南瓮河国家级自然保护区 景点级别	其他	单个
南瓮河国家级自然保护区 占地面积	数字+单位	单个
南瓮河国家级自然保护区 批准时间	数字+单位	单个
南瓮河国家级自然保护区 中文名称	其他	句子
丹霞山国家级自然保护区 景点级别	其他	单个
丹霞山国家级自然保护区 类型	其他	句子
丹霞山国家级自然保护区 气候	其他	句子
丹霞山国家级自然保护区 占地面积	数字+单位	单个
丹霞山国家级自然保护区 保护对象	其他	句子
丹霞山国家级自然保护区 气候类型	其他	句子
丹霞山国家级自然保护区 批准时间	数字+单位	单个
丹霞山国家级自然保护区 中文名称	其他	句子
南岭国家级自然保护区 地理位置	其他	句子
南岭国家级自然保护区 景点级别	其他	单个
南岭国家级自然保护区 占地面积	数字+单位	单个
南岭国家级自然保护区 保护对象	其他	句子
南岭国家级自然保护区 气候类型	其他	句子
南岭国家级自然保护区 批准时间	数字+单位	单个
南岭国家级自然保护区 中文名称	其他	句子
科尔沁国家级自然保护区 气候	其他	句子
科尔沁国家级自然保护区 气候类型	其他	句子
科尔沁国家级自然保护区 批准时间	数字+单位	单个
雾灵山国家级自然保护区 景点级别	其他	单个
雾灵山国家级自然保护区 级别	其他	单个
雾灵山国家级自然保护区 类型	其他	句子
雾灵山国家级自然保护区 占地面积	数字+单位	单个
雾灵山国家级自然保护区 保护对象	其他	句子
雾灵山国家级自然保护区 气候类型	其他	句子
雾灵山国家级自然保护区 批准时间	数字+单位	单个
红花尔基樟子松林国家级自然保护区 景点级别	其他	单个
红花尔基樟子松林国家级自然保护区 类型	其他	句子
红花尔基樟子松林国家级自然保护区 占地面积	数字+单位	单个
红花尔基樟子松林国家级自然保护区 气候类型	其他	句子
厦门珍稀海洋物种国家级自然保护区 景点级别	其他	单个
星斗山国家级自然保护区 景点级别	其他	单个
星斗山国家级自然保护区 级别	其他	单个
星斗山国家级自然保护区 批准时间	数字+单位	单个
茅荆坝国家级自然保护区 景点级别	其他	单个
茅荆坝国家级自然保护区 占地面积	数字+单位	单个
茅荆坝国家级自然保护区 气候类型	其他	句子
茅荆坝国家级自然保护区 中文名称	其他	句子
兴隆山国家级自然保护区 景点级别	其他	单个
兴隆山国家级自然保护区 批准时间	数字+单位	单个
五大连池国家级自然保护区 保护对象	其他	句子
五大连池国家级自然保护区 批准时间	数字+单位	单个
金寨天马国家级自然保护区 景点级别	其他	单个
金寨天马国家级自然保护区 批准时间	数字+单位	单个
石首麋鹿国家级自然保护区 地理位置	其他	句子
石首麋鹿国家级自然保护区 景点级别	其他	单个
石首麋鹿国家级自然保护区 占地面积	数字+单位	单个
石首麋鹿国家级自然保护区 气候类型	其他	句子
石首麋鹿国家级自然保护区 批准时间	数字+单位	单个
石首麋鹿国家级自然保护区 中文名称	其他	句子
哈腾套海国家级自然保护区 景点级别	其他	单个
哈腾套海国家级自然保护区 占地面积	数字+单位	单个
哈腾套海国家级自然保护区 气候类型	其他	句子
闽江源国家级自然保护区 景点级别	其他	单个
闽江源国家级自然保护区 占地面积	数字+单位	单个
闽江源国家级自然保护区 气候类型	其他	句子
闽江源国家级自然保护区 中文名称	其他	句子
升金湖国家级自然保护区 景点级别	其他	单个
升金湖国家级自然保护区 类型	其他	句子
升金湖国家级自然保护区 气候	其他	句子
升金湖国家级自然保护区 占地面积	数字+单位	单个
升金湖国家级自然保护区 气候类型	其他	句子
升金湖国家级自然保护区 批准时间	数字+单位	单个
白马雪山国家级自然保护区 批准时间	数字+单位	单个
黑里河国家级自然保护区 景点级别	其他	单个
黑里河国家级自然保护区 占地面积	数字+单位	单个
黑里河国家级自然保护区 气候类型	其他	句子
哈纳斯国家级自然保护区 保护对象	其他	句子
哈纳斯国家级自然保护区 批准时间	数字+单位	单个
小秦岭国家级自然保护区 批准时间	数字+单位	单个
昌黎黄金海岸国家级自然保护区 地理位置	其他	句子
昌黎黄金海岸国家级自然保护区 景点级别	其他	单个
昌黎黄金海岸国家级自然保护区 类型	其他	句子
昌黎黄金海岸国家级自然保护区 气候	其他	句子
昌黎黄金海岸国家级自然保护区 占地面积	数字+单位	单个
昌黎黄金海岸国家级自然保护区 气候类型	其他	句子
昌黎黄金海岸国家级自然保护区 中文名称	其他	句子
芦芽山国家级自然保护区 景点级别	其他	单个
芦芽山国家级自然保护区 占地面积	数字+单位	单个
芦芽山国家级自然保护区 气候类型	其他	句子
芦芽山国家级自然保护区 中文名称	其他	句子
小金四姑娘山国家级自然保护区 景点级别	其他	单个
小金四姑娘山国家级自然保护区 占地面积	数字+单位	单个
小金四姑娘山国家级自然保护区 气候类型	其他	句子
画稿溪国家级自然保护区 景点级别	其他	单个
画稿溪国家级自然保护区 批准时间	数字+单位	单个
大连斑海豹国家级自然保护区 景点级别	其他	单个
大连斑海豹国家级自然保护区 批准时间	数字+单位	单个
滨州贝壳堤岛与湿地国家级自然保护区 景点级别	其他	单个
滨州贝壳堤岛与湿地国家级自然保护区 占地面积	数字+单位	单个
滨州贝壳堤岛与湿地国家级自然保护区 气候类型	其他	句子
吊罗山国家级自然保护区 保护对象	其他	句子
吊罗山国家级自然保护区 批准时间	数字+单位	单个
古海岸与湿地国家级自然保护区 地理位置	其他	句子
古海岸与湿地国家级自然保护区 景点级别	其他	单个
古海岸与湿地国家级自然保护区 类型	其他	句子
古海岸与湿地国家级自然保护区 气候	其他	句子
古海岸与湿地国家级自然保护区 占地面积	数字+单位	单个
古海岸与湿地国家级自然保护区 气候类型	其他	句子
古海岸与湿地国家级自然保护区 批准时间	数字+单位	单个
古海岸与湿地国家级自然保护区 中文名称	其他	句子
宽阔水国家级自然保护区 保护对象	其他	句子
宽阔水国家级自然保护区 批准时间	数字+单位	单个
永州都庞岭国家级自然保护区 保护对象	其他	句子
永州都庞岭国家级自然保护区 批准时间	数字+单位	单个
金佛山国家级自然保护区 景点级别	其他	单个
金佛山国家级自然保护区 批准时间	数字+单位	单个
花坪国家级自然保护区 景点级别	其他	单个
花坪国家级自然保护区 级别	其他	单个
花坪国家级自然保护区 气候	其他	句子
花坪国家级自然保护区 占地面积	数字+单位	单个
花坪国家级自然保护区 气候类型	其他	句子
花坪国家级自然保护区 批准时间	数字+单位	单个
花坪国家级自然保护区 中文名称	其他	句子
南滚河国家级自然保护区 地理位置	其他	句子
南滚河国家级自然保护区 景点级别	其他	单个
南滚河国家级自然保护区 级别	其他	单个
南滚河国家级自然保护区 类型	其他	句子
南滚河国家级自然保护区 气候	其他	句子
南滚河国家级自然保护区 占地面积	数字+单位	单个
南滚河国家级自然保护区 保护对象	其他	句子
南滚河国家级自然保护区 气候类型	其他	句子
南滚河国家级自然保护区 批准时间	数字+单位	单个
南滚河国家级自然保护区 中文名称	其他	句子
松花江三湖国家级自然保护区 保护对象	其他	句子
松花江三湖国家级自然保护区 批准时间	数字+单位	单个
罗山国家级自然保护区 景点级别	其他	单个
罗山国家级自然保护区 占地面积	数字+单位	单个
罗山国家级自然保护区 气候类型	其他	句子
雅鲁藏布江中游河谷黑颈鹤国家级自然保护区 地理位置	其他	句子
雅鲁藏布江中游河谷黑颈鹤国家级自然保护区 景点级别	其他	单个
雅鲁藏布江中游河谷黑颈鹤国家级自然保护区 级别	其他	单个
雅鲁藏布江中游河谷黑颈鹤国家级自然保护区 类型	其他	句子
雅鲁藏布江中游河谷黑颈鹤国家级自然保护区 气候	其他	句子
雅鲁藏布江中游河谷黑颈鹤国家级自然保护区 占地面积	数字+单位	单个
雅鲁藏布江中游河谷黑颈鹤国家级自然保护区 保护对象	其他	句子
雅鲁藏布江中游河谷黑颈鹤国家级自然保护区 气候类型	其他	句子
雅鲁藏布江中游河谷黑颈鹤国家级自然保护区 批准时间	数字+单位	单个
雅鲁藏布江中游河谷黑颈鹤国家级自然保护区 中文名称	其他	句子
巴音布鲁克国家级自然保护区 地理位置	其他	句子
巴音布鲁克国家级自然保护区 景点级别	其他	单个
巴音布鲁克国家级自然保护区 级别	其他	单个
巴音布鲁克国家级自然保护区 气候	其他	句子
巴音布鲁克国家级自然保护区 占地面积	数字+单位	单个
巴音布鲁克国家级自然保护区 气候类型	其他	句子
巴音布鲁克国家级自然保护区 批准时间	数字+单位	单个
巴音布鲁克国家级自然保护区 中文名称	其他	句子
百花山国家级自然保护区 景点级别	其他	单个
百花山国家级自然保护区 级别	其他	单个
百花山国家级自然保护区 批准时间	数字+单位	单个
子午岭国家级自然保护区 景点级别	其他	单个
子午岭国家级自然保护区 批准时间	数字+单位	单个
北仑河口国家级自然保护区 地理位置	其他	句子
北仑河口国家级自然保护区 景点级别	其他	单个
北仑河口国家级自然保护区 级别	其他	单个
北仑河口国家级自然保护区 占地面积	数字+单位	单个
北仑河口国家级自然保护区 保护对象	其他	句子
北仑河口国家级自然保护区 气候类型	其他	句子
北仑河口国家级自然保护区 批准时间	数字+单位	单个
北仑河口国家级自然保护区 中文名称	其他	句子
千家洞国家级自然保护区 景点级别	其他	单个
大兴安岭汗马国家级自然保护区 保护对象	其他	句子
大兴安岭汗马国家级自然保护区 批准时间	数字+单位	单个
莫莫格国家级自然保护区 景点级别	其他	单个
莫莫格国家级自然保护区 级别	其他	单个
莫莫格国家级自然保护区 占地面积	数字+单位	单个
莫莫格国家级自然保护区 批准时间	数字+单位	单个
莫莫格国家级自然保护区 中文名称	其他	句子
黑龙江胜山国家级自然保护区 景点级别	其他	单个
黑龙江胜山国家级自然保护区 级别	其他	单个
黑龙江胜山国家级自然保护区 类型	其他	句子
黑龙江胜山国家级自然保护区 占地面积	数字+单位	单个
黑龙江胜山国家级自然保护区 保护对象	其他	句子
黑龙江胜山国家级自然保护区 气候类型	其他	句子
黑龙江胜山国家级自然保护区 批准时间	数字+单位	单个
天目山国家级自然保护区 地理位置	其他	句子
天目山国家级自然保护区 景点级别	其他	单个
天目山国家级自然保护区 级别	其他	单个
天目山国家级自然保护区 气候	其他	句子
天目山国家级自然保护区 占地面积	数字+单位	单个
天目山国家级自然保护区 气候类型	其他	句子
天目山国家级自然保护区 批准时间	数字+单位	单个
天目山国家级自然保护区 中文名称	其他	句子
防城金花茶国家级自然保护区 景点级别	其他	单个
防城金花茶国家级自然保护区 占地面积	数字+单位	单个
防城金花茶国家级自然保护区 气候类型	其他	句子
拉鲁湿地国家级自然保护区 景点级别	其他	单个
拉鲁湿地国家级自然保护区 占地面积	数字+单位	单个
拉鲁湿地国家级自然保护区 气候类型	其他	句子
安西极旱荒漠国家级自然保护区 景点级别	其他	单个
安西极旱荒漠国家级自然保护区 批准时间	数字+单位	单个
盐城沿海滩涂珍禽国家级自然保护区 景点级别	其他	单个
盐城沿海滩涂珍禽国家级自然保护区 气候	其他	句子
盐城沿海滩涂珍禽国家级自然保护区 占地面积	数字+单位	单个
盐城沿海滩涂珍禽国家级自然保护区 气候类型	其他	句子
白水河国家级自然保护区 保护对象	其他	句子
白水河国家级自然保护区 批准时间	数字+单位	单个
大丰麋鹿国家级自然保护区 景点级别	其他	单个
大丰麋鹿国家级自然保护区 类型	其他	句子
大丰麋鹿国家级自然保护区 占地面积	数字+单位	单个
大丰麋鹿国家级自然保护区 气候类型	其他	句子
大丰麋鹿国家级自然保护区 批准时间	数字+单位	单个
古田山国家级自然保护区 景点级别	其他	单个
古田山国家级自然保护区 级别	其他	单个
古田山国家级自然保护区 类型	其他	句子
古田山国家级自然保护区 气候	其他	句子
古田山国家级自然保护区 占地面积	数字+单位	单个
古田山国家级自然保护区 保护对象	其他	句子
古田山国家级自然保护区 气候类型	其他	句子
古田山国家级自然保护区 批准时间	数字+单位	单个
乌岩岭国家级自然保护区 地理位置	其他	句子
乌岩岭国家级自然保护区 景点级别	其他	单个
乌岩岭国家级自然保护区 级别	其他	单个
乌岩岭国家级自然保护区 类型	其他	句子
乌岩岭国家级自然保护区 气候	其他	句子
乌岩岭国家级自然保护区 占地面积	数字+单位	单个
乌岩岭国家级自然保护区 保护对象	其他	句子
乌岩岭国家级自然保护区 气候类型	其他	句子
乌岩岭国家级自然保护区 批准时间	数字+单位	单个
乌岩岭国家级自然保护区 中文名称	其他	句子
官山国家级自然保护区 地理位置	其他	句子
官山国家级自然保护区 景点级别	其他	单个
官山国家级自然保护区 类型	其他	句子
官山国家级自然保护区 占地面积	数字+单位	单个
官山国家级自然保护区 保护对象	其他	句子
官山国家级自然保护区 气候类型	其他	句子
官山国家级自然保护区 批准时间	数字+单位	单个
泗洪洪泽湖湿地国家级自然保护区 景点级别	其他	单个
泗洪洪泽湖湿地国家级自然保护区 级别	其他	单个
桃红岭梅花鹿国家级自然保护区 景点级别	其他	单个
桃红岭梅花鹿国家级自然保护区 级别	其他	单个
桃红岭梅花鹿国家级自然保护区 批准时间	数字+单位	单个
坝王岭国家级自然保护区 景点级别	其他	单个
坝王岭国家级自然保护区 占地面积	数字+单位	单个
坝王岭国家级自然保护区 气候类型	其他	句子
坝王岭国家级自然保护区 批准时间	数字+单位	单个
坝王岭国家级自然保护区 中文名称	其他	句子
类乌齐马鹿国家级自然保护区 景点级别	其他	单个
类乌齐马鹿国家级自然保护区 批准时间	数字+单位	单个
八面山国家级自然保护区 景点级别	其他	单个
八面山国家级自然保护区 保护对象	其他	句子
八面山国家级自然保护区 批准时间	数字+单位	单个
武夷山国家级自然保护区 地理位置	其他	句子
武夷山国家级自然保护区 景点级别	其他	单个
武夷山国家级自然保护区 级别	其他	单个
武夷山国家级自然保护区 类型	其他	句子
武夷山国家级自然保护区 气候	其他	句子
武夷山国家级自然保护区 占地面积	数字+单位	单个
武夷山国家级自然保护区 保护对象	其他	句子
武夷山国家级自然保护区 气候类型	其他	句子
武夷山国家级自然保护区 批准时间	数字+单位	单个
武夷山国家级自然保护区 中文名称	其他	句子
美姑大风顶国家级自然保护区 景点级别	其他	单个
炎陵桃源洞国家级自然保护区 占地面积	数字+单位	单个
炎陵桃源洞国家级自然保护区 批准时间	数字+单位	单个
长青国家级自然保护区 景点级别	其他	单个
长青国家级自然保护区 占地面积	数字+单位	单个
长青国家级自然保护区 气候类型	其他	句子
安南坝野骆驼国家级自然保护区 景点级别	其他	单个
安南坝野骆驼国家级自然保护区 批准时间	数字+单位	单个
湖北龙感湖国家级自然保护区 景点级别	其他	单个
红星湿地国家级自然保护区 批准时间	数字+单位	单个
雅鲁藏布大峡谷国家级自然保护区 景点级别	其他	单个
雅鲁藏布大峡谷国家级自然保护区 级别	其他	单个
雅鲁藏布大峡谷国家级自然保护区 类型	其他	句子
雅鲁藏布大峡谷国家级自然保护区 气候	其他	句子
雅鲁藏布大峡谷国家级自然保护区 占地面积	数字+单位	单个
雅鲁藏布大峡谷国家级自然保护区 保护对象	其他	句子
雅鲁藏布大峡谷国家级自然保护区 气候类型	其他	句子
雅鲁藏布大峡谷国家级自然保护区 批准时间	数字+单位	单个
祁连山国家级自然保护区 景点级别	其他	单个
祁连山国家级自然保护区 占地面积	数字+单位	单个
祁连山国家级自然保护区 气候类型	其他	句子
可可西里国家级自然保护区 景点级别	其他	单个
可可西里国家级自然保护区 气候	其他	句子
可可西里国家级自然保护区 占地面积	数字+单位	单个
可可西里国家级自然保护区 气候类型	其他	句子
可可西里国家级自然保护区 批准时间	数字+单位	单个
扬子鳄国家级自然保护区 保护对象	其他	句子
扬子鳄国家级自然保护区 批准时间	数字+单位	单个
弄岗国家级自然保护区 地理位置	其他	句子
弄岗国家级自然保护区 景点级别	其他	单个
弄岗国家级自然保护区 级别	其他	单个
弄岗国家级自然保护区 类型	其他	句子
弄岗国家级自然保护区 气候	其他	句子
弄岗国家级自然保护区 占地面积	数字+单位	单个
弄岗国家级自然保护区 保护对象	其他	句子
弄岗国家级自然保护区 气候类型	其他	句子
弄岗国家级自然保护区 批准时间	数字+单位	单个
苍山洱海国家级自然保护区 景点级别	其他	单个
苍山洱海国家级自然保护区 批准时间	数字+单位	单个
周至国家级自然保护区 景点级别	其他	单个
周至国家级自然保护区 占地面积	数字+单位	单个
周至国家级自然保护区 气候类型	其他	句子
达赉湖国家级自然保护区 景点级别	其他	单个
达赉湖国家级自然保护区 类型	其他	句子
达赉湖国家级自然保护区 气候	其他	句子
达赉湖国家级自然保护区 占地面积	数字+单位	单个
达赉湖国家级自然保护区 保护对象	其他	句子
达赉湖国家级自然保护区 气候类型	其他	句子
达赉湖国家级自然保护区 批准时间	数字+单位	单个
达赉湖国家级自然保护区 中文名称	其他	句子
大沾河湿地国家级自然保护区 保护对象	其他	句子
大沾河湿地国家级自然保护区 批准时间	数字+单位	单个
长白山国家级自然保护区 景点级别	其他	单个
长白山国家级自然保护区 占地面积	数字+单位	单个
长白山国家级自然保护区 气候类型	其他	句子
牯牛降国家级自然保护区 景点级别	其他	单个
牯牛降国家级自然保护区 气候	其他	句子
牯牛降国家级自然保护区 占地面积	数字+单位	单个
牯牛降国家级自然保护区 气候类型	其他	句子
牯牛降国家级自然保护区 批准时间	数字+单位	单个
牯牛降国家级自然保护区 中文名称	其他	句子
莽山国家级自然保护区 保护对象	其他	句子
莽山国家级自然保护区 批准时间	数字+单位	单个
八岔岛国家级自然保护区 景点级别	其他	单个
八岔岛国家级自然保护区 级别	其他	单个
八岔岛国家级自然保护区 占地面积	数字+单位	单个
八岔岛国家级自然保护区 保护对象	其他	句子
八岔岛国家级自然保护区 批准时间	数字+单位	单个
八岔岛国家级自然保护区 中文名称	其他	句子
蓟县中、上元古界地层剖面国家级自然保护区 景点级别	其他	单个
蓟县中、上元古界地层剖面国家级自然保护区 级别	其他	单个
蓟县中、上元古界地层剖面国家级自然保护区 类型	其他	句子
蓟县中、上元古界地层剖面国家级自然保护区 气候	其他	句子
蓟县中、上元古界地层剖面国家级自然保护区 占地面积	数字+单位	单个
蓟县中、上元古界地层剖面国家级自然保护区 气候类型	其他	句子
蓟县中、上元古界地层剖面国家级自然保护区 批准时间	数字+单位	单个
蓟县中、上元古界地层剖面国家级自然保护区 中文名称	其他	句子
大洲岛海洋生态国家级自然保护区 景点级别	其他	单个
大洲岛海洋生态国家级自然保护区 级别	其他	单个
大洲岛海洋生态国家级自然保护区 类型	其他	句子
大洲岛海洋生态国家级自然保护区 气候	其他	句子
大洲岛海洋生态国家级自然保护区 占地面积	数字+单位	单个
大洲岛海洋生态国家级自然保护区 保护对象	其他	句子
大洲岛海洋生态国家级自然保护区 气候类型	其他	句子
大洲岛海洋生态国家级自然保护区 批准时间	数字+单位	单个
鄱阳湖候鸟国家级自然保护区 景点级别	其他	单个
鄱阳湖候鸟国家级自然保护区 类型	其他	句子
鄱阳湖候鸟国家级自然保护区 占地面积	数字+单位	单个
鄱阳湖候鸟国家级自然保护区 气候类型	其他	句子
鄱阳湖候鸟国家级自然保护区 批准时间	数字+单位	单个
昆嵛山国家级自然保护区 景点级别	其他	单个
昆嵛山国家级自然保护区 批准时间	数字+单位	单个
珍宝岛湿地国家级自然保护区 景点级别	其他	单个
珍宝岛湿地国家级自然保护区 气候	其他	句子
珍宝岛湿地国家级自然保护区 占地面积	数字+单位	单个
珍宝岛湿地国家级自然保护区 保护对象	其他	句子
珍宝岛湿地国家级自然保护区 气候类型	其他	句子
珍宝岛湿地国家级自然保护区 中文名称	其他	句子
达里诺尔国家级自然保护区 景点级别	其他	单个
达里诺尔国家级自然保护区 批准时间	数字+单位	单个
无量山国家级自然保护区 地理位置	其他	句子
无量山国家级自然保护区 景点级别	其他	单个
无量山国家级自然保护区 气候	其他	句子
无量山国家级自然保护区 占地面积	数字+单位	单个
无量山国家级自然保护区 保护对象	其他	句子
无量山国家级自然保护区 气候类型	其他	句子
无量山国家级自然保护区 批准时间	数字+单位	单个
无量山国家级自然保护区 中文名称	其他	句子
盐池湾国家级自然保护区 景点级别	其他	单个
盐池湾国家级自然保护区 占地面积	数字+单位	单个
盐池湾国家级自然保护区 气候类型	其他	句子
壶瓶山国家级自然保护区 地理位置	其他	句子
壶瓶山国家级自然保护区 景点级别	其他	单个
壶瓶山国家级自然保护区 级别	其他	单个
壶瓶山国家级自然保护区 类型	其他	句子
壶瓶山国家级自然保护区 气候	其他	句子
壶瓶山国家级自然保护区 占地面积	数字+单位	单个
壶瓶山国家级自然保护区 保护对象	其他	句子
壶瓶山国家级自然保护区 气候类型	其他	句子
壶瓶山国家级自然保护区 批准时间	数字+单位	单个
三江源国家级自然保护区 景点级别	其他	单个
三江源国家级自然保护区 类型	其他	句子
三江源国家级自然保护区 占地面积	数字+单位	单个
三江源国家级自然保护区 气候类型	其他	句子
庞泉沟国家级自然保护区 景点级别	其他	单个
庞泉沟国家级自然保护区 气候	其他	句子
庞泉沟国家级自然保护区 占地面积	数字+单位	单个
庞泉沟国家级自然保护区 气候类型	其他	句子
豫北黄河故道湿地鸟类国家级自然保护区 景点级别	其他	单个
豫北黄河故道湿地鸟类国家级自然保护区 气候	其他	句子
豫北黄河故道湿地鸟类国家级自然保护区 占地面积	数字+单位	单个
豫北黄河故道湿地鸟类国家级自然保护区 气候类型	其他	句子
豫北黄河故道湿地鸟类国家级自然保护区 中文名称	其他	句子
海子山国家级自然保护区 地理位置	其他	句子
海子山国家级自然保护区 景点级别	其他	单个
海子山国家级自然保护区 级别	其他	单个
海子山国家级自然保护区 类型	其他	句子
海子山国家级自然保护区 气候	其他	句子
海子山国家级自然保护区 占地面积	数字+单位	单个
海子山国家级自然保护区 保护对象	其他	句子
海子山国家级自然保护区 气候类型	其他	句子
海子山国家级自然保护区 批准时间	数字+单位	单个
海子山国家级自然保护区 中文名称	其他	句子
大巴山国家级自然保护区 批准时间	数字+单位	单个
长江新螺段白鱀豚国家级自然保护区 景点级别	其他	单个
长江新螺段白鱀豚国家级自然保护区 气候	其他	句子
长江新螺段白鱀豚国家级自然保护区 占地面积	数字+单位	单个
长江新螺段白鱀豚国家级自然保护区 气候类型	其他	句子
长江新螺段白鱀豚国家级自然保护区 批准时间	数字+单位	单个
长江新螺段白鱀豚国家级自然保护区 中文名称	其他	句子
木论国家级自然保护区 保护对象	其他	句子
木论国家级自然保护区 批准时间	数字+单位	单个
唐家河国家级自然保护区 地理位置	其他	句子
唐家河国家级自然保护区 景点级别	其他	单个
唐家河国家级自然保护区 类型	其他	句子
唐家河国家级自然保护区 气候	其他	句子
唐家河国家级自然保护区 占地面积	数字+单位	单个
唐家河国家级自然保护区 保护对象	其他	句子
唐家河国家级自然保护区 气候类型	其他	句子
唐家河国家级自然保护区 批准时间	数字+单位	单个
唐家河国家级自然保护区 中文名称	其他	句子
小五台山国家级自然保护区 地理位置	其他	句子
小五台山国家级自然保护区 景点级别	其他	单个
小五台山国家级自然保护区 类型	其他	句子
小五台山国家级自然保护区 气候	其他	句子
小五台山国家级自然保护区 占地面积	数字+单位	单个
小五台山国家级自然保护区 保护对象	其他	句子
小五台山国家级自然保护区 气候类型	其他	句子
挠力河国家级自然保护区 保护对象	其他	句子
挠力河国家级自然保护区 批准时间	数字+单位	单个
扎龙国家级自然保护区 景点级别	其他	单个
扎龙国家级自然保护区 气候	其他	句子
扎龙国家级自然保护区 占地面积	数字+单位	单个
扎龙国家级自然保护区 气候类型	其他	句子
南岳衡山国家级自然保护区 景点级别	其他	单个
南岳衡山国家级自然保护区 级别	其他	单个
南岳衡山国家级自然保护区 批准时间	数字+单位	单个
西双版纳纳版河流域国家级自然保护区 景点级别	其他	单个
西双版纳纳版河流域国家级自然保护区 批准时间	数字+单位	单个
图牧吉国家级自然保护区 景点级别	其他	单个
图牧吉国家级自然保护区 级别	其他	单个
图牧吉国家级自然保护区 保护对象	其他	句子
图牧吉国家级自然保护区 批准时间	数字+单位	单个
辽宁医巫闾山国家级自然保护区 景点级别	其他	单个
辽宁医巫闾山国家级自然保护区 气候类型	其他	句子
辽宁医巫闾山国家级自然保护区 中文名称	其他	句子
灵武白芨滩国家级自然保护区 景点级别	其他	单个
灵武白芨滩国家级自然保护区 批准时间	数字+单位	单个
青木川国家级自然保护区 景点级别	其他	单个
青木川国家级自然保护区 占地面积	数字+单位	单个
青木川国家级自然保护区 气候类型	其他	句子
韩城褐马鸡国家级自然保护区 景点级别	其他	单个
韩城褐马鸡国家级自然保护区 批准时间	数字+单位	单个
岑王老山国家级自然保护区 景点级别	其他	单个
岑王老山国家级自然保护区 批准时间	数字+单位	单个
辽宁蛇岛老铁山国家级自然保护区 景点级别	其他	单个
辽宁蛇岛老铁山国家级自然保护区 占地面积	数字+单位	单个
辽宁蛇岛老铁山国家级自然保护区 气候类型	其他	句子
辽宁蛇岛老铁山国家级自然保护区 中文名称	其他	句子
托木尔峰国家级自然保护区 保护对象	其他	句子
托木尔峰国家级自然保护区 批准时间	数字+单位	单个
焦作太行山猕猴国家级自然保护区 景点级别	其他	单个
焦作太行山猕猴国家级自然保护区 类型	其他	句子
焦作太行山猕猴国家级自然保护区 占地面积	数字+单位	单个
焦作太行山猕猴国家级自然保护区 气候类型	其他	句子
焦作太行山猕猴国家级自然保护区 批准时间	数字+单位	单个
药山国家级自然保护区 景点级别	其他	单个
伊通火山群国家级自然保护区 保护对象	其他	句子
伊通火山群国家级自然保护区 批准时间	数字+单位	单个
洪河国家级自然保护区 批准时间	数字+单位	单个
丰林国家级自然保护区 地理位置	其他	句子
丰林国家级自然保护区 景点级别	其他	单个
丰林国家级自然保护区 级别	其他	单个
丰林国家级自然保护区 类型	其他	句子
丰林国家级自然保护区 气候	其他	句子
丰林国家级自然保护区 占地面积	数字+单位	单个
丰林国家级自然保护区 保护对象	其他	句子
丰林国家级自然保护区 气候类型	其他	句子
丰林国家级自然保护区 批准时间	数字+单位	单个
丰林国家级自然保护区 中文名称	其他	句子
黄河三角洲国家级自然保护区 类型	其他	句子
黄河三角洲国家级自然保护区 气候	其他	句子
黄河三角洲国家级自然保护区 气候类型	其他	句子
黄河三角洲国家级自然保护区 批准时间	数字+单位	单个
敦煌西湖国家级自然保护区 地理位置	其他	句子
敦煌西湖国家级自然保护区 景点级别	其他	单个
敦煌西湖国家级自然保护区 类型	其他	句子
敦煌西湖国家级自然保护区 占地面积	数字+单位	单个
敦煌西湖国家级自然保护区 气候类型	其他	句子
敦煌西湖国家级自然保护区 批准时间	数字+单位	单个
敦煌西湖国家级自然保护区 中文名称	其他	句子
佛坪国家级自然保护区 景点级别	其他	单个
佛坪国家级自然保护区 保护对象	其他	句子
佛坪国家级自然保护区 批准时间	数字+单位	单个
查干湖国家级自然保护区 景点级别	其他	单个
查干湖国家级自然保护区 批准时间	数字+单位	单个
梅花山国家级自然保护区 景点级别	其他	单个
梅花山国家级自然保护区 级别	其他	单个
梅花山国家级自然保护区 类型	其他	句子
梅花山国家级自然保护区 气候	其他	句子
梅花山国家级自然保护区 占地面积	数字+单位	单个
梅花山国家级自然保护区 保护对象	其他	句子
梅花山国家级自然保护区 气候类型	其他	句子
梅花山国家级自然保护区 批准时间	数字+单位	单个
梅花山国家级自然保护区 中文名称	其他	句子
虎口湿地自然保护区 地理位置	其他	句子
虎口湿地自然保护区 景点级别	其他	单个
虎口湿地自然保护区 级别	其他	单个
虎口湿地自然保护区 类型	其他	句子
虎口湿地自然保护区 气候	其他	句子
虎口湿地自然保护区 占地面积	数字+单位	单个
虎口湿地自然保护区 保护对象	其他	句子
虎口湿地自然保护区 气候类型	其他	句子
虎口湿地自然保护区 批准时间	数字+单位	单个
虎口湿地自然保护区 中文名称	其他	句子
长岛国家级自然保护区 地理位置	其他	句子
长岛国家级自然保护区 景点级别	其他	单个
长岛国家级自然保护区 类型	其他	句子
长岛国家级自然保护区 气候	其他	句子
长岛国家级自然保护区 占地面积	数字+单位	单个
长岛国家级自然保护区 气候类型	其他	句子
长岛国家级自然保护区 批准时间	数字+单位	单个
长岛国家级自然保护区 中文名称	其他	句子
草海国家级自然保护区 景点级别	其他	单个
草海国家级自然保护区 类型	其他	句子
草海国家级自然保护区 占地面积	数字+单位	单个
草海国家级自然保护区 气候类型	其他	句子
草海国家级自然保护区 批准时间	数字+单位	单个
凤凰山国家级自然保护区 景点级别	其他	单个
凤凰山国家级自然保护区 占地面积	数字+单位	单个
凤凰山国家级自然保护区 气候类型	其他	句子
雪宝顶国家级自然保护区 景点级别	其他	单个
雪宝顶国家级自然保护区 气候	其他	句子
雪宝顶国家级自然保护区 占地面积	数字+单位	单个
雪宝顶国家级自然保护区 气候类型	其他	句子
雪宝顶国家级自然保护区 中文名称	其他	句子
大青山国家级自然保护区 景点级别	其他	单个
大青山国家级自然保护区 批准时间	数字+单位	单个
芒康滇金丝猴国家级自然保护区 景点级别	其他	单个
芒康滇金丝猴国家级自然保护区 批准时间	数字+单位	单个
辽宁鸭绿江口滨海湿地国家级自然保护区 景点级别	其他	单个
辽宁鸭绿江口滨海湿地国家级自然保护区 级别	其他	单个
辽宁鸭绿江口滨海湿地国家级自然保护区 气候	其他	句子
辽宁鸭绿江口滨海湿地国家级自然保护区 气候类型	其他	句子
辽宁鸭绿江口滨海湿地国家级自然保护区 中文名称	其他	句子
向海国家级自然保护区 地理位置	其他	句子
向海国家级自然保护区 景点级别	其他	单个
向海国家级自然保护区 级别	其他	单个
向海国家级自然保护区 类型	其他	句子
向海国家级自然保护区 气候	其他	句子
向海国家级自然保护区 占地面积	数字+单位	单个
向海国家级自然保护区 保护对象	其他	句子
向海国家级自然保护区 气候类型	其他	句子
向海国家级自然保护区 批准时间	数字+单位	单个
向海国家级自然保护区 中文名称	其他	句子
会泽黑颈鹤国家级自然保护区 景点级别	其他	单个
会泽黑颈鹤国家级自然保护区 批准时间	数字+单位	单个
大海坨国家级自然保护区 保护对象	其他	句子
大海坨国家级自然保护区 批准时间	数字+单位	单个
龙湾国家级自然保护区 批准时间	数字+单位	单个
桓仁老秃顶子国家级自然保护区 景点级别	其他	单个
桓仁老秃顶子国家级自然保护区 级别	其他	单个
桓仁老秃顶子国家级自然保护区 类型	其他	句子
桓仁老秃顶子国家级自然保护区 占地面积	数字+单位	单个
桓仁老秃顶子国家级自然保护区 保护对象	其他	句子
桓仁老秃顶子国家级自然保护区 气候类型	其他	句子
桓仁老秃顶子国家级自然保护区 批准时间	数字+单位	单个
桓仁老秃顶子国家级自然保护区 中文名称	其他	句子
鼎湖山国家级自然保护区 景点级别	其他	单个
鼎湖山国家级自然保护区 类型	其他	句子
鼎湖山国家级自然保护区 占地面积	数字+单位	单个
鼎湖山国家级自然保护区 气候类型	其他	句子
辽宁仙人洞国家级自然保护区 地理位置	其他	句子
辽宁仙人洞国家级自然保护区 景点级别	其他	单个
辽宁仙人洞国家级自然保护区 级别	其他	单个
辽宁仙人洞国家级自然保护区 类型	其他	句子
辽宁仙人洞国家级自然保护区 气候	其他	句子
辽宁仙人洞国家级自然保护区 占地面积	数字+单位	单个
辽宁仙人洞国家级自然保护区 气候类型	其他	句子
辽宁仙人洞国家级自然保护区 批准时间	数字+单位	单个
莲花山国家级自然保护区 景点级别	其他	单个
莲花山国家级自然保护区 占地面积	数字+单位	单个
莲花山国家级自然保护区 气候类型	其他	句子
河北滦河上游国家级自然保护区 景点级别	其他	单个
河北滦河上游国家级自然保护区 占地面积	数字+单位	单个
河北滦河上游国家级自然保护区 气候类型	其他	句子
河北滦河上游国家级自然保护区 批准时间	数字+单位	单个
黄桑国家级自然保护区 类型	其他	句子
黄桑国家级自然保护区 气候	其他	句子
黄桑国家级自然保护区 保护对象	其他	句子
黄桑国家级自然保护区 气候类型	其他	句子
黄桑国家级自然保护区 批准时间	数字+单位	单个
崇明东滩鸟类国家级自然保护区 地理位置	其他	句子
崇明东滩鸟类国家级自然保护区 景点级别	其他	单个
崇明东滩鸟类国家级自然保护区 级别	其他	单个
崇明东滩鸟类国家级自然保护区 类型	其他	句子
崇明东滩鸟类国家级自然保护区 气候	其他	句子
崇明东滩鸟类国家级自然保护区 占地面积	数字+单位	单个
崇明东滩鸟类国家级自然保护区 保护对象	其他	句子
崇明东滩鸟类国家级自然保护区 气候类型	其他	句子
崇明东滩鸟类国家级自然保护区 批准时间	数字+单位	单个
崇明东滩鸟类国家级自然保护区 中文名称	其他	句子
马边大风顶国家级自然保护区 保护对象	其他	句子
马边大风顶国家级自然保护区 批准时间	数字+单位	单个
太白山国家级自然保护区 景点级别	其他	单个
太白山国家级自然保护区 占地面积	数字+单位	单个
太白山国家级自然保护区 气候类型	其他	句子
雷公山国家级自然保护区 景点级别	其他	单个
雷公山国家级自然保护区 级别	其他	单个
雷公山国家级自然保护区 类型	其他	句子
雷公山国家级自然保护区 气候	其他	句子
雷公山国家级自然保护区 占地面积	数字+单位	单个
雷公山国家级自然保护区 保护对象	其他	句子
雷公山国家级自然保护区 气候类型	其他	句子
雷公山国家级自然保护区 批准时间	数字+单位	单个
雷公山国家级自然保护区 中文名称	其他	句子
大围山国家级自然保护区 景点级别	其他	单个
大围山国家级自然保护区 批准时间	数字+单位	单个
鹞落坪国家级自然保护区 景点级别	其他	单个
鹞落坪国家级自然保护区 批准时间	数字+单位	单个
南阳恐龙蛋化石群国家级自然保护区 景点级别	其他	单个
南阳恐龙蛋化石群国家级自然保护区 级别	其他	单个
南阳恐龙蛋化石群国家级自然保护区 保护对象	其他	句子
南阳恐龙蛋化石群国家级自然保护区 批准时间	数字+单位	单个
九寨沟国家级自然保护区 保护对象	其他	句子
九寨沟国家级自然保护区 批准时间	数字+单位	单个
罗布泊野骆驼国家级自然保护区 批准时间	数字+单位	单个
青龙山恐龙蛋化石群国家级自然保护区 地理位置	其他	句子
青龙山恐龙蛋化石群国家级自然保护区 景点级别	其他	单个
青龙山恐龙蛋化石群国家级自然保护区 级别	其他	单个
青龙山恐龙蛋化石群国家级自然保护区 类型	其他	句子
青龙山恐龙蛋化石群国家级自然保护区 气候	其他	句子
青龙山恐龙蛋化石群国家级自然保护区 占地面积	数字+单位	单个
青龙山恐龙蛋化石群国家级自然保护区 保护对象	其他	句子
青龙山恐龙蛋化石群国家级自然保护区 气候类型	其他	句子
青龙山恐龙蛋化石群国家级自然保护区 批准时间	数字+单位	单个
青龙山恐龙蛋化石群国家级自然保护区 中文名称	其他	句子
五指山国家级自然保护区 景点级别	其他	单个
五指山国家级自然保护区 级别	其他	单个
五指山国家级自然保护区 类型	其他	句子
五指山国家级自然保护区 占地面积	数字+单位	单个
五指山国家级自然保护区 保护对象	其他	句子
五指山国家级自然保护区 气候类型	其他	句子
五指山国家级自然保护区 批准时间	数字+单位	单个
五指山国家级自然保护区 中文名称	其他	句子
历山国家级自然保护区 景点级别	其他	单个
历山国家级自然保护区 批准时间	数字+单位	单个
甘家湖梭梭林国家级自然保护区 保护对象	其他	句子
甘家湖梭梭林国家级自然保护区 批准时间	数字+单位	单个
五鹿山国家级自然保护区 景点级别	其他	单个
五鹿山国家级自然保护区 占地面积	数字+单位	单个
五鹿山国家级自然保护区 批准时间	数字+单位	单个
王朗国家级自然保护区 景点级别	其他	单个
王朗国家级自然保护区 批准时间	数字+单位	单个
山旺古生物化石国家级自然保护区 地理位置	其他	句子
山旺古生物化石国家级自然保护区 景点级别	其他	单个
山旺古生物化石国家级自然保护区 级别	其他	单个
山旺古生物化石国家级自然保护区 气候	其他	句子
山旺古生物化石国家级自然保护区 占地面积	数字+单位	单个
山旺古生物化石国家级自然保护区 保护对象	其他	句子
山旺古生物化石国家级自然保护区 气候类型	其他	句子
山旺古生物化石国家级自然保护区 批准时间	数字+单位	单个
戴云山国家级自然保护区 批准时间	数字+单位	单个
隆宝国家级自然保护区 景点级别	其他	单个
隆宝国家级自然保护区 保护对象	其他	句子
隆宝国家级自然保护区 批准时间	数字+单位	单个
董寨国家级自然保护区 地理位置	其他	句子
董寨国家级自然保护区 景点级别	其他	单个
董寨国家级自然保护区 级别	其他	单个
董寨国家级自然保护区 气候	其他	句子
董寨国家级自然保护区 占地面积	数字+单位	单个
董寨国家级自然保护区 气候类型	其他	句子
董寨国家级自然保护区 批准时间	数字+单位	单个
董寨国家级自然保护区 中文名称	其他	句子
惠东港口海龟国家级自然保护区 地理位置	其他	句子
惠东港口海龟国家级自然保护区 景点级别	其他	单个
惠东港口海龟国家级自然保护区 级别	其他	单个
惠东港口海龟国家级自然保护区 气候	其他	句子
惠东港口海龟国家级自然保护区 占地面积	数字+单位	单个
惠东港口海龟国家级自然保护区 气候类型	其他	句子
惠东港口海龟国家级自然保护区 批准时间	数字+单位	单个
惠东港口海龟国家级自然保护区 中文名称	其他	句子
鸭绿江上游国家级自然保护区 景点级别	其他	单个
鸭绿江上游国家级自然保护区 级别	其他	单个
鸭绿江上游国家级自然保护区 类型	其他	句子
鸭绿江上游国家级自然保护区 气候	其他	句子
鸭绿江上游国家级自然保护区 占地面积	数字+单位	单个
鸭绿江上游国家级自然保护区 保护对象	其他	句子
鸭绿江上游国家级自然保护区 气候类型	其他	句子
鸭绿江上游国家级自然保护区 批准时间	数字+单位	单个
鸭绿江上游国家级自然保护区 中文名称	其他	句子
八大公山国家级自然保护区 景点级别	其他	单个
八大公山国家级自然保护区 级别	其他	单个
八大公山国家级自然保护区 类型	其他	句子
八大公山国家级自然保护区 占地面积	数字+单位	单个
八大公山国家级自然保护区 保护对象	其他	句子
八大公山国家级自然保护区 气候类型	其他	句子
八大公山国家级自然保护区 批准时间	数字+单位	单个
八大公山国家级自然保护区 中文名称	其他	句子
缙云山国家级自然保护区 保护对象	其他	句子
缙云山国家级自然保护区 批准时间	数字+单位	单个
雷州珍稀水生动物国家级自然保护区 批准时间	数字+单位	单个
海棠山国家级自然保护区 景点级别	其他	单个
海棠山国家级自然保护区 批准时间	数字+单位	单个
鸡公山国家级自然保护区 景点级别	其他	单个
鸡公山国家级自然保护区 级别	其他	单个
鸡公山国家级自然保护区 类型	其他	句子
鸡公山国家级自然保护区 气候	其他	句子
鸡公山国家级自然保护区 占地面积	数字+单位	单个
鸡公山国家级自然保护区 保护对象	其他	句子
鸡公山国家级自然保护区 气候类型	其他	句子
鸡公山国家级自然保护区 批准时间	数字+单位	单个
鸡公山国家级自然保护区 中文名称	其他	句子
连康山国家级自然保护区 保护对象	其他	句子
连康山国家级自然保护区 批准时间	数字+单位	单个
阳明山国家级自然保护区 类型	其他	句子
阳明山国家级自然保护区 气候	其他	句子
阳明山国家级自然保护区 保护对象	其他	句子
阳明山国家级自然保护区 气候类型	其他	句子
阳明山国家级自然保护区 批准时间	数字+单位	单个
色林错国家级自然保护区 类型	其他	句子
色林错国家级自然保护区 气候	其他	句子
色林错国家级自然保护区 气候类型	其他	句子
色林错国家级自然保护区 批准时间	数字+单位	单个
察隅慈巴沟国家级自然保护区 景点级别	其他	单个
察隅慈巴沟国家级自然保护区 占地面积	数字+单位	单个
察隅慈巴沟国家级自然保护区 气候类型	其他	句子
卧龙国家级自然保护区 地理位置	其他	句子
卧龙国家级自然保护区 景点级别	其他	单个
卧龙国家级自然保护区 级别	其他	单个
卧龙国家级自然保护区 气候	其他	句子
卧龙国家级自然保护区 占地面积	数字+单位	单个
卧龙国家级自然保护区 气候类型	其他	句子
卧龙国家级自然保护区 批准时间	数字+单位	单个
卧龙国家级自然保护区 中文名称	其他	句子
赛罕乌拉国家级自然保护区 景点级别	其他	单个
赛罕乌拉国家级自然保护区 占地面积	数字+单位	单个
赛罕乌拉国家级自然保护区 气候类型	其他	句子
赛罕乌拉国家级自然保护区 批准时间	数字+单位	单个
赛罕乌拉国家级自然保护区 中文名称	其他	句子
黄河湿地国家级自然保护区 景点级别	其他	单个
黄河湿地国家级自然保护区 类型	其他	句子
黄河湿地国家级自然保护区 气候	其他	句子
黄河湿地国家级自然保护区 占地面积	数字+单位	单个
黄河湿地国家级自然保护区 气候类型	其他	句子
米仓山国家级自然保护区 保护对象	其他	句子
米仓山国家级自然保护区 批准时间	数字+单位	单个
沙坡头国家级自然保护区 占地面积	数字+单位	单个
沙坡头国家级自然保护区 保护对象	其他	句子
沙坡头国家级自然保护区 气候类型	其他	句子
猫儿山国家级自然保护区 景点级别	其他	单个
猫儿山国家级自然保护区 级别	其他	单个
猫儿山国家级自然保护区 类型	其他	句子
猫儿山国家级自然保护区 气候	其他	句子
猫儿山国家级自然保护区 占地面积	数字+单位	单个
猫儿山国家级自然保护区 气候类型	其他	句子
猫儿山国家级自然保护区 批准时间	数字+单位	单个
猫儿山国家级自然保护区 中文名称	其他	句子
大盘山国家级自然保护区 景点级别	其他	单个
大盘山国家级自然保护区 占地面积	数字+单位	单个
大盘山国家级自然保护区 气候类型	其他	句子
车八岭国家级自然保护区 景点级别	其他	单个
车八岭国家级自然保护区 保护对象	其他	句子
虎伯寮国家级自然保护区 保护对象	其他	句子
虎伯寮国家级自然保护区 批准时间	数字+单位	单个
黑龙江双河国家级自然保护区 保护对象	其他	句子
黑龙江双河国家级自然保护区 批准时间	数字+单位	单个
茂兰国家级自然保护区 景点级别	其他	单个
茂兰国家级自然保护区 占地面积	数字+单位	单个
茂兰国家级自然保护区 气候类型	其他	句子
茂兰国家级自然保护区 中文名称	其他	句子
黑龙江乌伊岭国家级自然保护区 景点级别	其他	单个
黑龙江乌伊岭国家级自然保护区 占地面积	数字+单位	单个
黑龙江乌伊岭国家级自然保护区 保护对象	其他	句子
黑龙江乌伊岭国家级自然保护区 气候类型	其他	句子
黑龙江乌伊岭国家级自然保护区 批准时间	数字+单位	单个
丹江湿地国家级自然保护区 景点级别	其他	单个
丹江湿地国家级自然保护区 占地面积	数字+单位	单个
丹江湿地国家级自然保护区 气候类型	其他	句子
丹江湿地国家级自然保护区 批准时间	数字+单位	单个
丹江湿地国家级自然保护区 中文名称	其他	句子
九宫山国家级自然保护区 景点级别	其他	单个
九宫山国家级自然保护区 级别	其他	单个
九宫山国家级自然保护区 批准时间	数字+单位	单个
青海湖国家级自然保护区 景点级别	其他	单个
青海湖国家级自然保护区 类型	其他	句子
青海湖国家级自然保护区 占地面积	数字+单位	单个
青海湖国家级自然保护区 保护对象	其他	句子
青海湖国家级自然保护区 气候类型	其他	句子
青海湖国家级自然保护区 批准时间	数字+单位	单个
天华山国家级自然保护区 批准时间	数字+单位	单个
太子山国家级自然保护区 景点级别	其他	单个
太子山国家级自然保护区 批准时间	数字+单位	单个
桑园国家级自然保护区 景点级别	其他	单个
桑园国家级自然保护区 批准时间	数字+单位	单个
成山头海滨地貌国家级自然保护区 批准时间	数字+单位	单个
麻阳河国家级自然保护区 景点级别	其他	单个
麻阳河国家级自然保护区 级别	其他	单个
麻阳河国家级自然保护区 保护对象	其他	句子
麻阳河国家级自然保护区 批准时间	数字+单位	单个
东寨港国家级自然保护区 景点级别	其他	单个
东寨港国家级自然保护区 级别	其他	单个
东寨港国家级自然保护区 类型	其他	句子
东寨港国家级自然保护区 占地面积	数字+单位	单个
东寨港国家级自然保护区 气候类型	其他	句子
东寨港国家级自然保护区 批准时间	数字+单位	单个
西天山国家级自然保护区 保护对象	其他	句子
西天山国家级自然保护区 批准时间	数字+单位	单个
牡丹峰国家级自然保护区 景点级别	其他	单个
大田国家级自然保护区 保护对象	其他	句子
大田国家级自然保护区 批准时间	数字+单位	单个
漳江口红树林国家级自然保护区 保护对象	其他	句子
漳江口红树林国家级自然保护区 批准时间	数字+单位	单个
双台河口国家级自然保护区 景点级别	其他	单个
双台河口国家级自然保护区 类型	其他	句子
双台河口国家级自然保护区 气候	其他	句子
双台河口国家级自然保护区 保护对象	其他	句子
双台河口国家级自然保护区 气候类型	其他	句子
双台河口国家级自然保护区 批准时间	数字+单位	单个
大瑶山国家级自然保护区 地理位置	其他	句子
大瑶山国家级自然保护区 景点级别	其他	单个
大瑶山国家级自然保护区 级别	其他	单个
大瑶山国家级自然保护区 气候	其他	句子
大瑶山国家级自然保护区 占地面积	数字+单位	单个
大瑶山国家级自然保护区 保护对象	其他	句子
大瑶山国家级自然保护区 气候类型	其他	句子
大瑶山国家级自然保护区 批准时间	数字+单位	单个
大瑶山国家级自然保护区 中文名称	其他	句子
锡林郭勒草原国家级自然保护区 景点级别	其他	单个
锡林郭勒草原国家级自然保护区 级别	其他	单个
锡林郭勒草原国家级自然保护区 批准时间	数字+单位	单个
锡林郭勒草原国家级自然保护区 中文名称	其他	句子
将乐龙栖山国家级自然保护区 气候	其他	句子
将乐龙栖山国家级自然保护区 保护对象	其他	句子
将乐龙栖山国家级自然保护区 气候类型	其他	句子
将乐龙栖山国家级自然保护区 批准时间	数字+单位	单个
大山包黑颈鹤国家级自然保护区 景点级别	其他	单个
大山包黑颈鹤国家级自然保护区 批准时间	数字+单位	单个
江西武夷山国家级自然保护区 地理位置	其他	句子
江西武夷山国家级自然保护区 景点级别	其他	单个
江西武夷山国家级自然保护区 级别	其他	单个
江西武夷山国家级自然保护区 类型	其他	句子
江西武夷山国家级自然保护区 气候	其他	句子
江西武夷山国家级自然保护区 占地面积	数字+单位	单个
江西武夷山国家级自然保护区 保护对象	其他	句子
江西武夷山国家级自然保护区 气候类型	其他	句子
江西武夷山国家级自然保护区 批准时间	数字+单位	单个
江西武夷山国家级自然保护区 中文名称	其他	句子
围场红松洼国家级自然保护区 地理位置	其他	句子
围场红松洼国家级自然保护区 景点级别	其他	单个
围场红松洼国家级自然保护区 级别	其他	单个
围场红松洼国家级自然保护区 类型	其他	句子
围场红松洼国家级自然保护区 气候	其他	句子
围场红松洼国家级自然保护区 占地面积	数字+单位	单个
围场红松洼国家级自然保护区 气候类型	其他	句子
围场红松洼国家级自然保护区 批准时间	数字+单位	单个
围场红松洼国家级自然保护区 中文名称	其他	句子
贡嘎山国家级自然保护区 地理位置	其他	句子
贡嘎山国家级自然保护区 景点级别	其他	单个
贡嘎山国家级自然保护区 级别	其他	单个
贡嘎山国家级自然保护区 占地面积	数字+单位	单个
贡嘎山国家级自然保护区 气候类型	其他	句子
贡嘎山国家级自然保护区 中文名称	其他	句子
攀枝花苏铁国家级自然保护区 批准时间	数字+单位	单个
金平分水岭国家级自然保护区 景点级别	其他	单个
长江天鹅洲白鱀豚国家级自然保护区 景点级别	其他	单个
长江天鹅洲白鱀豚国家级自然保护区 占地面积	数字+单位	单个
长江天鹅洲白鱀豚国家级自然保护区 气候类型	其他	句子
长江天鹅洲白鱀豚国家级自然保护区 批准时间	数字+单位	单个
长江天鹅洲白鱀豚国家级自然保护区 中文名称	其他	句子
宝天曼国家级自然保护区 地理位置	其他	句子
宝天曼国家级自然保护区 景点级别	其他	单个
宝天曼国家级自然保护区 级别	其他	单个
宝天曼国家级自然保护区 占地面积	数字+单位	单个
宝天曼国家级自然保护区 保护对象	其他	句子
穆棱东北红豆杉国家级自然保护区 批准时间	数字+单位	单个
君子峰国家级自然保护区 气候	其他	句子
君子峰国家级自然保护区 保护对象	其他	句子
君子峰国家级自然保护区 气候类型	其他	句子
君子峰国家级自然保护区 批准时间	数字+单位	单个
塞罕坝国家级自然保护区 景点级别	其他	单个
塞罕坝国家级自然保护区 保护对象	其他	句子
荣成大天鹅国家级自然保护区 景点级别	其他	单个
徐闻珊瑚礁国家级自然保护区 保护对象	其他	句子
徐闻珊瑚礁国家级自然保护区 批准时间	数字+单位	单个
白水江国家级自然保护区 景点级别	其他	单个
白水江国家级自然保护区 类型	其他	句子
白水江国家级自然保护区 占地面积	数字+单位	单个
白水江国家级自然保护区 气候类型	其他	句子
东洞庭湖国家级自然保护区 景点级别	其他	单个
连城国家级自然保护区 地理位置	其他	句子
连城国家级自然保护区 类型	其他	句子
连城国家级自然保护区 气候	其他	句子
连城国家级自然保护区 保护对象	其他	句子
连城国家级自然保护区 气候类型	其他	句子
连城国家级自然保护区 批准时间	数字+单位	单个
黄连山国家级自然保护区 景点级别	其他	单个
尖峰岭国家级自然保护区 类型	其他	句子
尖峰岭国家级自然保护区 气候	其他	句子
尖峰岭国家级自然保护区 气候类型	其他	句子
尖峰岭国家级自然保护区 批准时间	数字+单位	单个
松山国家级自然保护区 地理位置	其他	句子
松山国家级自然保护区 景点级别	其他	单个
松山国家级自然保护区 级别	其他	单个
松山国家级自然保护区 类型	其他	句子
松山国家级自然保护区 气候	其他	句子
松山国家级自然保护区 占地面积	数字+单位	单个
松山国家级自然保护区 保护对象	其他	句子
松山国家级自然保护区 气候类型	其他	句子
松山国家级自然保护区 批准时间	数字+单位	单个
松山国家级自然保护区 中文名称	其他	句子
鄂尔多斯遗鸥国家级自然保护区 景点级别	其他	单个
鄂尔多斯遗鸥国家级自然保护区 气候	其他	句子
鄂尔多斯遗鸥国家级自然保护区 占地面积	数字+单位	单个
鄂尔多斯遗鸥国家级自然保护区 气候类型	其他	句子
鄂尔多斯遗鸥国家级自然保护区 中文名称	其他	句子
化龙山国家级自然保护区 景点级别	其他	单个
化龙山国家级自然保护区 批准时间	数字+单位	单个
鹰嘴界国家级自然保护区 保护对象	其他	句子
鹰嘴界国家级自然保护区 气候类型	其他	句子
九段沙湿地国家级自然保护区 景点级别	其他	单个
九段沙湿地国家级自然保护区 级别	其他	单个
九段沙湿地国家级自然保护区 占地面积	数字+单位	单个
九段沙湿地国家级自然保护区 保护对象	其他	句子
九段沙湿地国家级自然保护区 气候类型	其他	句子
九段沙湿地国家级自然保护区 批准时间	数字+单位	单个
九段沙湿地国家级自然保护区 中文名称	其他	句子
额尔古纳国家级自然保护区 景点级别	其他	单个
额尔古纳国家级自然保护区 批准时间	数字+单位	单个
汉中朱鹮国家级自然保护区 景点级别	其他	单个
汉中朱鹮国家级自然保护区 批准时间	数字+单位	单个
亚丁国家级自然保护区 景点级别	其他	单个
亚丁国家级自然保护区 占地面积	数字+单位	单个
亚丁国家级自然保护区 气候类型	其他	句子
九连山国家级自然保护区 类型	其他	句子
九连山国家级自然保护区 气候	其他	句子
九连山国家级自然保护区 气候类型	其他	句子
九连山国家级自然保护区 批准时间	数字+单位	单个
梵净山国家级自然保护区 景点级别	其他	单个
梵净山国家级自然保护区 气候	其他	句子
梵净山国家级自然保护区 占地面积	数字+单位	单个
梵净山国家级自然保护区 气候类型	其他	句子
梵净山国家级自然保护区 批准时间	数字+单位	单个
梵净山国家级自然保护区 中文名称	其他	句子
像头山国家级自然保护区 批准时间	数字+单位	单个
伏牛山国家级自然保护区 景点级别	其他	单个
伏牛山国家级自然保护区 批准时间	数字+单位	单个
六盘山国家级自然保护区 地理位置	其他	句子
六盘山国家级自然保护区 景点级别	其他	单个
六盘山国家级自然保护区 级别	其他	单个
六盘山国家级自然保护区 占地面积	数字+单位	单个
六盘山国家级自然保护区 保护对象	其他	句子
六盘山国家级自然保护区 气候类型	其他	句子
六盘山国家级自然保护区 批准时间	数字+单位	单个
六盘山国家级自然保护区 中文名称	其他	句子
西鄂尔多斯国家级自然保护区 景点级别	其他	单个
西鄂尔多斯国家级自然保护区 批准时间	数字+单位	单个
珠穆朗玛峰国家级自然保护区 地理位置	其他	句子
珠穆朗玛峰国家级自然保护区 景点级别	其他	单个
珠穆朗玛峰国家级自然保护区 级别	其他	单个
珠穆朗玛峰国家级自然保护区 类型	其他	句子
珠穆朗玛峰国家级自然保护区 气候	其他	句子
珠穆朗玛峰国家级自然保护区 占地面积	数字+单位	单个
珠穆朗玛峰国家级自然保护区 保护对象	其他	句子
珠穆朗玛峰国家级自然保护区 气候类型	其他	句子
珠穆朗玛峰国家级自然保护区 批准时间	数字+单位	单个
辉河国家级自然保护区 景点级别	其他	单个
辉河国家级自然保护区 级别	其他	单个
辉河国家级自然保护区 气候	其他	句子
辉河国家级自然保护区 占地面积	数字+单位	单个
辉河国家级自然保护区 保护对象	其他	句子
辉河国家级自然保护区 气候类型	其他	句子
辉河国家级自然保护区 批准时间	数字+单位	单个
长兴地质遗迹国家级自然保护区 景点级别	其他	单个
长兴地质遗迹国家级自然保护区 占地面积	数字+单位	单个
长兴地质遗迹国家级自然保护区 气候类型	其他	句子
习水中亚热带常绿阔叶林国家级自然保护区 批准时间	数字+单位	单个
察青松多白唇鹿国家级自然保护区 景点级别	其他	单个
察青松多白唇鹿国家级自然保护区 级别	其他	单个
察青松多白唇鹿国家级自然保护区 气候	其他	句子
察青松多白唇鹿国家级自然保护区 占地面积	数字+单位	单个
察青松多白唇鹿国家级自然保护区 气候类型	其他	句子
察青松多白唇鹿国家级自然保护区 批准时间	数字+单位	单个
呼中国家级自然保护区 保护对象	其他	句子
呼中国家级自然保护区 批准时间	数字+单位	单个
三江国家级自然保护区 保护对象	其他	句子
三江国家级自然保护区 批准时间	数字+单位	单个
洪湖湿地国家级自然保护区 景点级别	其他	单个
洪湖湿地国家级自然保护区 占地面积	数字+单位	单个
洪湖湿地国家级自然保护区 气候类型	其他	句子
永德大雪山国家级自然保护区 景点级别	其他	单个
永德大雪山国家级自然保护区 批准时间	数字+单位	单个
七姊妹山国家级自然保护区 景点级别	其他	单个
七姊妹山国家级自然保护区 级别	其他	单个
七姊妹山国家级自然保护区 批准时间	数字+单位	单个
铜陵淡水豚国家级自然保护区 景点级别	其他	单个
铜陵淡水豚国家级自然保护区 批准时间	数字+单位	单个
塔里木胡杨国家级自然保护区 地理位置	其他	句子
塔里木胡杨国家级自然保护区 景点级别	其他	单个
塔里木胡杨国家级自然保护区 级别	其他	单个
塔里木胡杨国家级自然保护区 类型	其他	句子
塔里木胡杨国家级自然保护区 占地面积	数字+单位	单个
塔里木胡杨国家级自然保护区 保护对象	其他	句子
塔里木胡杨国家级自然保护区 气候类型	其他	句子
塔里木胡杨国家级自然保护区 批准时间	数字+单位	单个
神农架国家级自然保护区 批准时间	数字+单位	单个
五峰后河国家级自然保护区 景点级别	其他	单个
五峰后河国家级自然保护区 占地面积	数字+单位	单个
五峰后河国家级自然保护区 气候类型	其他	句子
西双版纳国家级自然保护区 保护对象	其他	句子
西双版纳国家级自然保护区 批准时间	数字+单位	单个
山口红树林生态国家级自然保护区 景点级别	其他	单个
山口红树林生态国家级自然保护区 类型	其他	句子
山口红树林生态国家级自然保护区 气候	其他	句子
山口红树林生态国家级自然保护区 占地面积	数字+单位	单个
山口红树林生态国家级自然保护区 气候类型	其他	句子
山口红树林生态国家级自然保护区 批准时间	数字+单位	单个
井冈山国家级自然保护区 景点级别	其他	单个
井冈山国家级自然保护区 占地面积	数字+单位	单个
井冈山国家级自然保护区 气候类型	其他	句子
深沪湾海底古森林遗迹国家级自然保护区 地理位置	其他	句子
深沪湾海底古森林遗迹国家级自然保护区 景点级别	其他	单个
深沪湾海底古森林遗迹国家级自然保护区 类型	其他	句子
深沪湾海底古森林遗迹国家级自然保护区 气候	其他	句子
深沪湾海底古森林遗迹国家级自然保护区 占地面积	数字+单位	单个
深沪湾海底古森林遗迹国家级自然保护区 气候类型	其他	句子
深沪湾海底古森林遗迹国家级自然保护区 批准时间	数字+单位	单个
深沪湾海底古森林遗迹国家级自然保护区 中文名称	其他	句子
梁野山国家级自然保护区 景点级别	其他	单个
民勤连古城国家级自然保护区 批准时间	数字+单位	单个
若尔盖湿地国家级自然保护区 景点级别	其他	单个
若尔盖湿地国家级自然保护区 级别	其他	单个
若尔盖湿地国家级自然保护区 占地面积	数字+单位	单个
若尔盖湿地国家级自然保护区 批准时间	数字+单位	单个
十万大山国家级自然保护区 地理位置	其他	句子
十万大山国家级自然保护区 景点级别	其他	单个
十万大山国家级自然保护区 占地面积	数字+单位	单个
十万大山国家级自然保护区 保护对象	其他	句子
十万大山国家级自然保护区 气候类型	其他	句子
十万大山国家级自然保护区 批准时间	数字+单位	单个
十万大山国家级自然保护区 中文名称	其他	句子
小陇山国家级自然保护区 保护对象	其他	句子
小陇山国家级自然保护区 批准时间	数字+单位	单个
鄂托克恐龙遗迹化石国家级自然保护区 批准时间	数字+单位	单个
衡水湖国家级自然保护区 景点级别	其他	单个
衡水湖国家级自然保护区 批准时间	数字+单位	单个
哈泥国家级自然保护区 保护对象	其他	句子
哈泥国家级自然保护区 批准时间	数字+单位	单个
乌云界国家级自然保护区 景点级别	其他	单个
借母溪国家级自然保护区 地理位置	其他	句子
借母溪国家级自然保护区 景点级别	其他	单个
借母溪国家级自然保护区 级别	其他	单个
借母溪国家级自然保护区 类型	其他	句子
借母溪国家级自然保护区 气候	其他	句子
借母溪国家级自然保护区 占地面积	数字+单位	单个
借母溪国家级自然保护区 保护对象	其他	句子
借母溪国家级自然保护区 气候类型	其他	句子
借母溪国家级自然保护区 批准时间	数字+单位	单个
借母溪国家级自然保护区 中文名称	其他	句子
东方红湿地国家级自然保护区 景点级别	其他	单个
东方红湿地国家级自然保护区 级别	其他	单个
东方红湿地国家级自然保护区 批准时间	数字+单位	单个
花萼山国家级自然保护区 景点级别	其他	单个
花萼山国家级自然保护区 占地面积	数字+单位	单个
花萼山国家级自然保护区 气候类型	其他	句子
宝清七星河国家级自然保护区 景点级别	其他	单个
宝清七星河国家级自然保护区 级别	其他	单个
宝清七星河国家级自然保护区 气候	其他	句子
宝清七星河国家级自然保护区 占地面积	数字+单位	单个
宝清七星河国家级自然保护区 保护对象	其他	句子
宝清七星河国家级自然保护区 气候类型	其他	句子
宝清七星河国家级自然保护区 中文名称	其他	句子
天宝岩国家级自然保护区 景点级别	其他	单个
天宝岩国家级自然保护区 级别	其他	单个
天宝岩国家级自然保护区 保护对象	其他	句子
