陆地来水量	数字+单位	单个
地理位置	百科实体	多个
最大水深	数字+单位	单个
含盐度	数字+单位	单个
海区平均气温	百科实体	多个
平均深度	数字+单位	单个
年蒸发量	数字+单位	单个
平均盐度	数字+单位	单个
主要海峡	百科实体	多个
主要资源	百科实体	多个
海岸线	数字+单位	单个
最大宽度	数字+单位	单个
海水温度	数字+单位	单个
面积	数字+单位	单个
年平均降水量	数字+单位	单个
中文名	其他	单个
最深处	百科实体	单个
主要水体	百科实体	多个
外文名	百科实体	多个
沿岸国家	百科实体	多个
海岸线长度	数字+单位	单个
气候类型	其他	多个
平均水温	数字+单位	单个
周边国家	百科实体	多个
别称	其他	句子
海岸线长	数字+单位	单个
平均水深	数字+单位	单个
南北跨度	数字+单位	单个
主要岛屿	百科实体	多个
东西跨度	数字+单位	单个
典型盐度	数字+单位	单个
最深点	其他	句子
年交换量	数字+单位	单个
主要群岛	百科实体	多个
