陆缘冰面积	数字+单位	单个
全称	地名	单个
气候	百科实体	多个
平均风速	数字+单位	单个
最高峰	百科实体	单个
行政区类别	其他	单个
本义	其他	句子
标准时间	其他	句子
岛屿面积	数字+单位	单个
人口数量	数字+单位	单个
电话区号	数字+单位	单个
重要城市	地名	多个
气候条件	百科实体	多个
语言	地名	多个
主要民族	百科实体	多个
冰层平均厚度	数字+单位	单个
外文名	其他	单个
最低点	其他	句子
所属地区	其他	单个
下辖地区	百科实体	多个
意译	其他	单个
别称	其他	单个
著名景点	百科实体	多个
人均GDP	数字+单位	单个
总面积	数字+单位	单个
著名岛屿	其他	单个
地区GDP	数字+单位	单个
最大都市	百科实体	单个
人口密度	数字+单位	单个
别名	其他	单个
地理位置	百科实体	多个
历史最低气温	其他	句子
民族	其他	句子
国家和地区	数字+单位	单个
主要宗教	百科实体	多个
主要资源	百科实体	单个
代表性	其他	单个
陆地平均海拔	数字+单位	单个
陆地面积	数字+单位	单个
面积	数字+单位	单个
外文名缩写	其他	单个
人口	数字+单位	单个
年平均降水量	数字+单位	单个
主要国家	百科实体	多个
中文名	百科实体	单个
海岸线长度	数字+单位	单个
总冰量	数字+单位	单个
方言	百科实体	多个
中文名称	其他	单个
最大城市	地名	单个
外文名称	其他	单个
最高点	数字+单位	单个
主要语言	百科实体	多个
