域名	其他	单个
历法	百科实体	单个
代表事物	百科实体	多个
注音	百科实体	多个
时区	其他	句子
年号	百科实体	单个
政府代码	其他	单个
主要气候	其他	句子
中文古称	百科实体	单个
重要政党	百科实体	多个
电话区号	其他	单个
著名赛道	百科实体	单个
最大高原	百科实体	单个
国家领袖	人名	多个
主要航空公司	百科实体	单个
国家元首	人名	单个
国王日	数字+单位	单个
政治信仰	百科实体	单个
建交日期	数字+单位	单个
国家美誉	百科实体	单个
历史人物	人名	多个
首脑	其他	句子
著名高校	地名	多个
日均生活费	数字+单位	单个
国兽	百科实体	单个
标准普尔评级	其他	单个
汇率	数字+单位	单个
特色产品	其他	单个
著名景点	百科实体	多个
海拔	数字+单位	单个
首都	地名	单个
国果	百科实体	单个
政治体制	其他	句子
货币换算	数字+单位	单个
国际电话码	数字	单个
通用文字	地名	单个
经济增长率	数字+单位	单个
原名	百科实体	单个
货币单位	其他	单个
名人	人名	多个
国际域名缩写	其他	单个
地理位置	其他	句子
国宝	百科实体	单个
重要事件	数字+单位	单个
著名公司	百科实体	多个
最高建筑	百科实体	单个
文化思想	百科实体	多个
中立日	数字+单位	单个
配音	人名	单个
主要高等学府	地名	多个
主要宗教	百科实体	多个
人种	百科实体	单个
气候分布	百科实体	多个
航空运输	百科实体	单个
死亡率	数字+单位	单个
人类发展指数	数字	单个
人口	数字+单位	单个
国家名胜	其他	句子
名胜	其他	单个
火车站	其他	单个
登场作品	其他	句子
首席大法官	其他	句子
最大城市	其他	单个
国旗	百科实体	单个
F1赛道	百科实体	单个
外文名称	其他	多个
代表人物	人名	多个
最高点	百科实体	单个
宗教信仰	百科实体	单个
拼音	百科实体	多个
著名汽车赛事	百科实体	单个
简称	其他	单个
类型	其他	单个
出生率	数字+单位	单个
代表动物	百科实体	多个
国家结构形式	百科实体	单个
汽车品牌	百科实体	多个
主要学府	其他	多个
主要城市	百科实体	多个
总督	其他	句子
古称	百科实体	多个
气候	其他	单个
现役军人数	数字	单个
国家顶级域名	百科实体	单个
国庆日	数字+单位	单个
海上运输	其他	句子
省长	其他	句子
主要经济收入	百科实体	多个
誉称	百科实体	单个
国语	其他	单个
国石	百科实体	单个
中央银行	百科实体	单个
气候条件	其他	单个
同北京时差	百科实体	多个
塔希提语名	百科实体	多个
主要民族	百科实体	多个
国际组织	百科实体	多个
所属地区	百科实体	单个
宗教	百科实体	单个
法语名称	百科实体	多个
国球	百科实体	单个
土耳其语	百科实体	多个
行政区划	数字+单位	单个
官网	其他	句子
水域面积	数字+单位	单个
时差	地名	单个
元首	其他	句子
最长河流	百科实体	单个
国名法语	百科实体	多个
官方文字	百科实体	多个
国树	百科实体	单个
在意的人	其他	句子
人口密度	数字+单位	单个
失业率	数字+单位	单个
其它	百科实体	多个
国鸟	百科实体	单个
国舞	地名	单个
政治元老	人名	多个
著名赛事	百科实体	多个
西班牙语名称	百科实体	多个
成立时间	数字+单位	单个
国家银行	百科实体	单个
面积	数字+单位	单个
国土面积	数字+单位	单个
中文名称	其他	句子
性别	其他	单个
世界遗产	地名	单个
华人族群	百科实体	多个
汽车企业	百科实体	单个
所属国家	其他	单个
电压	数字+单位	单个
国名拉丁文	百科实体	多个
年降水量	其他	句子
旧名	百科实体	单个
英语	其他	单个
GDP总计	数字+单位	单个
宪法实施日	数字+单位	单个
外汇储备	数字+单位	单个
国家政权	百科实体	单个
GDP	数字+单位	单个
夏时制	其他	单个
海岸线	数字+单位	单个
所属国际组织	百科实体	多个
高等学府	地名	多个
重要河流	百科实体	多个
水域率	数字+单位	单个
著名企业	百科实体	多个
建国国父	人名	单个
色彩禁忌	百科实体	多个
国庆	数字+单位	单个
流行群体	其他	单个
专用顶级域名	其他	单个
通讯社	百科实体	单个
总理	其他	句子
别称	其他	单个
基尼指数	数字	单个
民族象征	百科实体	多个
人均GDP	数字+单位	单个
体育活动	百科实体	多个
法律体系	百科实体	单个
法定语言	地名	单个
国际域名	其他	单个
阿拉伯语	百科实体	多个
车牌代码	数字	多个
政府首脑	人名	单个
别名	其他	单个
建交时间	数字+单位	单个
斯瓦希里语	百科实体	多个
格言	其他	句子
机场	百科实体	单个
地区性组织	百科实体	单个
货  币	其他	单个
中心城市	百科实体	单个
邮政区码	数字	单个
国际电话区号	其他	单个
法文名	百科实体	多个
国花	百科实体	单个
中文名	其他	单个
政府财政支出	数字+单位	单个
地理方位	百科实体	单个
国际组织成员	百科实体	多个
方言	百科实体	多个
著名人物	人名	多个
主要事件	百科实体	多个
爪夷文	其他	句子
主要节日	其他	单个
政府驻地	其他	单个
标志性建筑物	其他	单个
代码	其他	单个
地理最高峰	其他	单个
最大运河	地名	单个
国家代码	其他	单个
GDP增长率	数字+单位	单个
著名汽车品牌	百科实体	单个
所属大洲	地名	单个
最大岛屿	其他	单个
最大机场	百科实体	单个
顶级域名	其他	单个
行政区类别	其他	单个
土地资源	其他	句子
国别域名	其他	句子
解放日	数字+单位	单个
人口数量	数字+单位	单个
其他名称	其他	句子
港口	百科实体	多个
主要铁路公司	百科实体	单个
华民系	百科实体	多个
希腊语	其他	句子
语言	百科实体	单个
汽车赛事	其他	句子
官方语言	百科实体	单个
宗教圣地	地名	多个
外文名	其他	单个
最大行政区	百科实体	单个
所属洲	其他	单个
平均降雨量	数字+单位	单个
下辖地区	其他	多个
货币	百科实体	单个
国家元首代表	其他	句子
重要节日	百科实体	多个
国家格言	其他	句子
国家象征	百科实体	多个
阿拉伯语国名	其他	句子
与中国关系	其他	单个
道路通行	其他	单个
基尼系数	数字	单个
行政等级	其他	句子
英文名称	其他	多个
最大湖泊	百科实体	单个
主要河流	百科实体	单个
森林覆盖率	数字+单位	单个
地理最高点	其他	单个
所属地形区	地名	单个
西班牙语	其他	单个
组成	百科实体	多个
通货膨胀率	数字+单位	单个
主要机场	其他	句子
立国日期	数字+单位	单个
葡萄牙名称	百科实体	多个
通用语言	百科实体	单个
位置	其他	单个
政治体系	百科实体	多个
著名节日	地名	单个
邻近海域	百科实体	多个
政府所在地	地名	单个
民族	百科实体	单个
首府	其他	单个
奇楚瓦语	其他	单个
政区	数字+单位	单个
国家结构	百科实体	单个
独立日	数字+单位	单个
国家权力体制	百科实体	单个
军队节日	其他	句子
国土面积排名	其他	句子
时  区	其他	单个
国际机场	百科实体	多个
国歌	百科实体	句子
气候类型	地名	单个
国名意大利语	百科实体	多个
民俗	百科实体	多个
地区代码	其他	单个
主要岛屿	百科实体	多个
国教	其他	单个
政党	百科实体	多个
国旗日	数字+单位	单个
政体	百科实体	单个
法语国名	百科实体	多个
国花，国鸟	百科实体	多个
共和国成立日	数字+单位	单个
主要湖泊	百科实体	单个
立国事件	其他	句子
文化圈	其他	单个
