高速公路	百科实体	多个
足球学校	地名	单个
注音	百科实体	多个
著名战役	百科实体	多个
时区	其他	单个
称号	百科实体	单个
轨道交通系统	其他	句子
主要居民	百科实体	多个
市 树	百科实体	多个
国家级新区	其他	单个
特色旅游	百科实体	单个
途经高速铁路	百科实体	单个
途经国道	百科实体	多个
人均花费	数字+单位	单个
农作物	百科实体	多个
片长	数字+单位	单个
现任队长	人名	单个
电话区号	数字	单个
行政区划代码	数字	单个
现任知事	人名	单个
市旗	其他	句子
建城	其他	句子
市区人口	数字+单位	单个
解放纪念日	数字+单位	多个
领导	人名	多个
版纳特产	百科实体	句子
本科院校	地名	多个
著名高校	地名	多个
出生地	其他	单个
市花、市鸟	百科实体	多个
城市球队	地名	单个
目标定位	其他	句子
著名景点	百科实体	多个
海拔	数字+单位	单个
主演	人名	多个
首相	其他	句子
海底隧道	百科实体	多个
最佳游玩季节	其他	单个
主场馆	百科实体	单个
球队主席	百科实体	单个
县树	其他	单个
政治中心	百科实体	单个
邮编	数字	单个
客家围	百科实体	多个
原名	其他	单个
城市地位	百科实体	多个
州委书记	人名	单个
名人	人名	多个
国际域名缩写	其他	单个
GNP	数字+单位	单个
行政代码	数字	单个
电站	百科实体	多个
最高建筑	其他	单个
小  吃	百科实体	单个
经济	百科实体	多个
市鸟	百科实体	单个
港口吞吐量	数字+单位	单个
国家	其他	单个
配音	人名	单个
高速	百科实体	单个
主要宗教	百科实体	多个
高校	地名	多个
CUBU	其他	句子
双拥共建标志	百科实体	单个
陆地面积	数字	多个
人口	数字+单位	单个
人类发展指数	数字	单个
著名学府	地名	多个
星座	其他	单个
主要工业	百科实体	多个
火车站	百科实体	多个
首席部长	人名	单个
代表作品	百科实体	单个
建城日期	数字+单位	单个
历史别称	百科实体	多个
最大城市	其他	单个
外文名称	其他	单个
年平均气温	数字+单位	单个
原版名称	其他	单个
主要高等院校	百科实体	多个
拼音	百科实体	多个
机场代码	其他	单个
主要学府	地名	多个
夏令时间	其他	单个
海拔高度	数字+单位	单个
主要城市	百科实体	多个
达州精神	百科实体	句子
建立时间	数字+单位	单个
所属政党	地名	单个
国家顶级域名	百科实体	单个
民俗文化	百科实体	单个
职位	其他	句子
最大产业	百科实体	多个
高等学校	地名	多个
创始人	人名	单个
誉称	其他	句子
气温	其他	句子
立市	数字+单位	单个
州花	其他	单个
著名节会	其他	句子
所属城市	其他	单个
城市地标	百科实体	单个
朝阳名人	人名	多个
球衣广告	百科实体	单个
途经铁路	百科实体	多个
主要民族	百科实体	多个
国际组织	百科实体	单个
副队长	人名	单个
国际赛事	百科实体	单个
生日	数字+单位	单个
宗教	百科实体	单个
2012人均GDP	数字+单位	单个
被誉为	百科实体	多个
文化遗产	百科实体	多个
音乐	百科实体	多个
最佳旅游时间	数字+单位	单个
行政区划	其他	句子
代州长	其他	单个
城市定位	百科实体	句子
桥梁	百科实体	多个
市花；市树	百科实体	多个
美誉	百科实体	单个
水域面积	数字	单个
市树/市花	百科实体	单个
国民生产总值	数字+单位	单个
生产总值	数字+单位	单个
地方特产	其他	多个
标志	百科实体	单个
市花/树/鸟	百科实体	单个
主保圣人	人名	单个
誉为	百科实体	多个
高教园区	百科实体	多个
主城区人口	数字+单位	单个
邮政代码	数字	单个
人口密度	数字+单位	单个
主要高校	地名	多个
市树、市花	百科实体	多个
主要配音	人名	多个
人文典故	百科实体	多个
最低工资	数字+单位	单个
市领导	人名	多个
四大班子领导	人名	多个
体重	数字+单位	单个
都鸟	百科实体	单个
政治元老	人名	多个
电影	地名	单个
成立时间	数字+单位	单个
代市长	人名	单个
主城区GDP	数字+单位	单个
旅游总人数	数字+单位	单个
汽车站	其他	多个
知名产业	其他	单个
知名高校	百科实体	单个
郡	其他	单个
市花，市树	百科实体	多个
市花	百科实体	单个
主要产业	其他	多个
海岸线长度	数字+单位	单个
城市宣言	百科实体	句子
主要成就	百科实体	单个
中文名称	其他	单个
最高学府	地名	单个
国际友好城市	地名	多个
世界遗产	百科实体	多个
所属国家	其他	单个
城市建设目标	百科实体	多个
少数民族	百科实体	多个
主要领导	人名	多个
国籍	其他	单个
娱乐名人	百科实体	多个
人种构成	数字+单位	多个
城市分级	百科实体	单个
著名军事学府	百科实体	单个
年降水量	数字+单位	单个
主要荣誉	百科实体	单个
现状	其他	单个
现代名人	人名	多个
海域面积	数字+单位	单个
GDP总计	数字+单位	单个
收入中位数	数字+单位	单个
党委书记	人名	单个
地铁日均客流	数字+单位	单个
地区生产总值	数字+单位	单个
著名特产	百科实体	多个
体育经理	人名	单个
海岸线	数字+单位	单个
人口增长率	数字+单位	单个
代理市长	人名	单个
主要港口	百科实体	多个
队歌	百科实体	多个
实际所属	百科实体	多个
建国国父	人名	单个
著名企业	百科实体	多个
南充市花	其他	单个
住户存款总额	数字+单位	单个
师父	人名	单个
州歌	百科实体	句子
城市代码	其他	单个
历史	其他	句子
市花及市树	百科实体	单个
民间信仰	人名	多个
2016年GDP	数字+单位	单个
别称	其他	单个
人均GDP	数字+单位	单个
建成区面积	数字+单位	单个
总面积	数字+单位	单个
死敌	地名	单个
世界文化遗产	百科实体	多个
公共财政收入	数字+单位	单个
车牌代码	其他	单个
客运站	其他	句子
乐山精神	其他	句子
历史名人	人名	多个
都花	百科实体	单个
高铁站	百科实体	多个
界	其他	单个
足球队	地名	单个
又名	其他	单个
市花/市鸟	百科实体	单个
中文队名	其他	句子
城轨	百科实体	单个
建城时间	数字+单位	单个
高等院校2	地名	多个
人均gdp	数字+单位	单个
高等院校1	地名	多个
邮政区码	数字	单个
地委书记	人名	单个
门票价格	其他	单个
高　　校	百科实体	多个
消费品零售额	数字+单位	单个
角逐赛事	百科实体	单个
著名大学	地名	单个
铁路	百科实体	句子
现任书记	人名	单个
码头	其他	句子
户籍人口	数字+单位	单个
城市类别	其他	句子
拍摄日期	数字+单位	单个
当政领导	人名	多个
官方微博	其他	单个
市花市鸟市树	百科实体	多个
经纬度	数字+单位	多个
爱好	其他	单个
名菜	百科实体	单个
古今名人	人名	多个
降水量	其他	句子
著名人物	人名	多个
分级	其他	句子
地理坐标	百科实体	句子
球衣号码	数字+单位	单个
政府驻地	其他	单个
城市格言	百科实体	单个
学校	地名	多个
市 花	百科实体	单个
高等院校	地名	多个
代码	数字	单个
纬度	百科实体	多个
市歌	百科实体	单个
现任主教练	人名	单个
城市轨道	百科实体	单个
主场队服	百科实体	句子
市委书记	人名	单个
出品时间	数字+单位	单个
作画监督	百科实体	多个
行政区类别	其他	单个
矿产资源	百科实体	多个
所获荣誉	百科实体	多个
电话编码	其他	单个
行政级别	百科实体	多个
人口数量	数字+单位	单个
其它译名	其他	单个
其他名称	其他	单个
地标建筑	百科实体	单个
身高	数字+单位	单个
著名俱乐部	地名	多个
国家制度	其他	句子
守护神	其他	句子
客场队服	百科实体	句子
主要街道	其他	单个
夏时令	百科实体	单个
拉丁学名	百科实体	多个
货币	百科实体	单个
种族	数字+单位	多个
释义	其他	句子
剧本	人名	单个
途经高速	百科实体	多个
书记/市长	人名	单个
姐妹城市	百科实体	单个
市委副书记	人名	单个
主要河流	地名	多个
语音	其他	单个
经度	百科实体	多个
夏令时	其他	单个
财政收入	数字+单位	单个
佛山座右铭	百科实体	多个
名校	地名	多个
森林覆盖率	数字+单位	单个
地方生产总值	数字+单位	单个
矿藏	其他	单个
所属运动队	百科实体	单个
知名企业	百科实体	多个
开放时间	数字+单位	单个
专科院校	百科实体	多个
大市区人口	数字	单个
主要信仰	百科实体	单个
城市品牌	百科实体	多个
著名机构	百科实体	多个
科	其他	单个
重点高校	地名	多个
主要特产	百科实体	多个
领导信息	人名	多个
占地面积	数字+单位	单个
球衣供应	百科实体	单个
经济开发区	地名	单个
小吃	百科实体	多个
执政党	百科实体	多个
文化名片	百科实体	多个
国际机场	百科实体	多个
所属国	百科实体	单个
城市主题	百科实体	多个
开发区	百科实体	多个
门	百科实体	多个
气候类型	其他	单个
特色美食	百科实体	多个
总经理	其他	句子
动画制作	百科实体	单个
性质	百科实体	单个
市花树鸟	百科实体	单个
单赛季胜场	数字+单位	单个
市徽	百科实体	单个
经纬度位置	数字+单位	单个
友好城市	地名	多个
出生日期	数字+单位	单个
创建时间	数字+单位	单个
古代人物	人名	多个
分区	其他	单个
书记	人名	单个
地区	其他	单个
历代名人	人名	多个
科研机构	其他	句子
容纳人数	数字+单位	单个
年均降水量	数字+单位	单个
总统	其他	句子
城市人口	数字+单位	单个
城市精神	其他	多个
城镇化率	数字+单位	单个
城市由来	百科实体	多个
所属	其他	句子
军衔	百科实体	单个
城市名人	人名	多个
地位	百科实体	多个
都会区人口	数字	单个
著名高中	地名	多个
编剧	人名	单个
国家领袖	百科实体	多个
角色设计	百科实体	多个
被称为	其他	句子
市花、市树	百科实体	多个
历史人物	人名	多个
城市等级	其他	单个
接待游客	数字+单位	单个
国内排名	数字	单个
城市轨道交通	地名	单个
海外姐妹市	百科实体	多个
人文古迹	百科实体	多个
首都	地名	单个
平均海拔	数字+单位	单个
政治体制	其他	句子
建议游玩时长	数字+单位	单个
地形	其他	单个
代表企业	百科实体	多个
地名涵义	其他	单个
城市口号	其他	多个
城市旅游品牌	百科实体	句子
拥有者	人名	单个
市区面积	数字+单位	单个
市树	百科实体	单个
贷款余额	数字+单位	单个
传统节日	百科实体	单个
地理位置	其他	句子
景点级别	其他	句子
县鸟	人名	单个
重要事件	数字+单位	单个
市标	百科实体	单个
市人大主任	人名	单个
全市生产总值	数字+单位	单个
名义所属国家	百科实体	单个
主要发展	其他	句子
昵称	其他	单个
列入名录年份	数字+单位	单个
对口帮扶城市	其他	单个
人均收入	数字+单位	单个
体育场	其他	句子
城市节庆	百科实体	多个
著名院校	地名	多个
知名中学	地名	多个
汽车客运站	百科实体	多个
壮文名称	百科实体	多个
登场作品	地名	单个
标准时区	百科实体	单个
万吨级港口	百科实体	单个
近代名人	人名	多个
著名高等学府	地名	单个
知名人物	人名	多个
代表人物	人名	多个
首播电视台	地名	多个
大型演出	其他	句子
轨道交通	百科实体	单个
州元首	其他	句子
市辖区面积	数字+单位	单个
2013年GDP	其他	句子
奥克西坦语	其他	单个
简称	其他	单个
类型	其他	单个
特色节日	地名	单个
gdp总量	数字+单位	单个
建城年代	其他	句子
著名中学	百科实体	多个
主要院校	地名	多个
亚门	百科实体	多个
区划代码	数字	单个
名称来源	其他	句子
创市时间	数字+单位	单个
适宜游玩季节	数字+单位	单个
古称	百科实体	单个
气候	地名	单个
商圈	百科实体	多个
城市规模	其他	句子
拍摄地点	百科实体	单个
平均气温	数字+单位	单个
国庆日	数字+单位	单个
城市GDP	数字+单位	单个
发行	百科实体	单个
导演	百科实体	单个
主要奖项	数字+单位	单个
中心方位	其他	句子
地标性建筑	百科实体	多个
气候条件	其他	句子
财政总收入	数字+单位	单个
下辖街道	数字+单位	单个
途经城际铁路	百科实体	多个
都树	百科实体	单个
imdb编码	其他	单个
所属地区	其他	单个
城区主干道	百科实体	单个
联邦直辖市日	数字+单位	单个
商丘名人	人名	多个
专业方向	其他	句子
城市座右铭	其他	多个
城市建成区	数字+单位	单个
外文队名	百科实体	多个
时间	其他	单个
纲	百科实体	多个
官网	其他	句子
制片成本	数字+单位	单个
成立	数字+单位	单个
特色文化	百科实体	多个
祖鲁语	其他	单个
当代名人	人名	多个
知名商场	百科实体	多个
坐标	数字+单位	多个
地区GDP	数字+单位	单个
发行时间	数字+单位	单个
行政区码	数字	单个
代理发行	其他	句子
运动项目	百科实体	单个
常住人口	数字+单位	单个
典故	百科实体	多个
国鸟	百科实体	单个
城市四大名片	百科实体	多个
州格言	其他	句子
高等学院	地名	单个
境内都城	地名	单个
网络播放	百科实体	单个
经济总量	数字+单位	单个
县花	百科实体	单个
近现代人物	人名	多个
游戏	地名	单个
特殊荣誉	其他	句子
地标	其他	句子
面积	数字+单位	单个
出品公司	其他	单个
市 鸟	百科实体	单个
当地特产	百科实体	多个
主要人种	百科实体	单个
政府编号	数字	单个
代表性建筑	百科实体	多个
存款余额	数字+单位	单个
国土面积	数字+单位	单个
少数民族语言	百科实体	多个
目	其他	单个
市树、花、鸟	百科实体	多个
性别	其他	单个
典故传说	地名	单个
名酒	百科实体	多个
中文学名	其他	单个
德比	其他	句子
曾用名	地名	单个
城市标志	百科实体	多个
科研院所	其他	句子
地方名吃	百科实体	多个
市河	其他	单个
国家区号	其他	单个
美食	百科实体	多个
球衣赞助	其他	单个
绰号	其他	单个
知名院校	地名	单个
2012年GDP	数字+单位	单个
公园	百科实体	单个
年平均温度	数字+单位	单个
现任领导	人名	多个
IATA机场代码	其他	单个
使用语言	百科实体	单个
GDP	数字+单位	单个
大学	地名	多个
宿雾	百科实体	句子
主要轻工产品	百科实体	多个
驾车规则	其他	单个
进出岛跨海桥	百科实体	多个
高等学府	地名	多个
建立	数字+单位	单个
德语	其他	单个
城市特产	百科实体	多个
地名由来	百科实体	句子
水域率	数字+单位	单个
城市荣誉	百科实体	多个
信仰	百科实体	单个
足球俱乐部	百科实体	多个
色彩	其他	单个
总理	其他	句子
城市新区	百科实体	多个
隶属国家	其他	单个
尊称	百科实体	句子
可支配收入	其他	单个
设置年代	数字+单位	单个
市树市花	百科实体	多个
最高海拔	数字	多个
gdp	数字+单位	单个
其他电视台	百科实体	单个
斩魄刀	百科实体	单个
建成区人口	数字+单位	单个
都会区	数字	单个
州党委书记	人名	单个
特产	百科实体	多个
职业	其他	单个
国内生产总值	数字+单位	单个
高速铁路	百科实体	单个
归属	其他	单个
别名	其他	多个
港口代码	其他	单个
陆域面积	数字+单位	单个
城市形象标识	其他	单个
机场	百科实体	单个
队长	人名	单个
亚纲	其他	单个
GDP总量	数字+单位	单个
特色小吃	百科实体	多个
每集长度	其他	句子
训练场	其他	单个
市纪委书记	人名	单个
主席	百科实体	单个
血型	其他	单个
市花/市树	百科实体	单个
国际电话区号	其他	单个
定名时间	数字+单位	单个
国花	百科实体	单个
中文名	其他	单个
地区区号	数字	单个
旅游节庆	百科实体	单个
名胜古迹	百科实体	单个
城市象征	百科实体	多个
州长	人名	单个
民俗活动	其他	句子
方言	百科实体	单个
市人均GDP	数字+单位	单个
美  食	百科实体	单个
标志性事件	百科实体	单个
历史地位	地名	单个
集数	数字+单位	单个
国家代码	其他	单个
建州时间	数字+单位	单个
居民名称	其他	单个
地名来源	地名	单个
现任市长	人名	单个
著名小吃	百科实体	多个
逝世日期	数字+单位	单个
途经普速铁路	百科实体	单个
中心位置	数字+单位	多个
制片地区	百科实体	单个
获城市权	数字+单位	单个
上映时间	数字+单位	单个
重点中学	地名	多个
全市面积	数字+单位	单个
海拔最高点	百科实体	单个
降水	其他	句子
平均温度	数字+单位	单个
海港	百科实体	单个
荣誉	百科实体	单个
原作	人名	单个
毕业院校	其他	句子
港口	百科实体	单个
始建年份	数字+单位	单个
市树，市花	百科实体	多个
地铁	百科实体	多个
城市名片	百科实体	单个
建市时间	数字+单位	单个
亚目	百科实体	多个
华民系	百科实体	多个
中心城区人口	数字+单位	单个
语言	百科实体	单个
淮安精神	百科实体	句子
官方语言	地名	单个
外文名	其他	多个
所属洲	其他	单个
下辖地区	数字+单位	多个
著名遗址	百科实体	多个
重要节日	百科实体	多个
人均生产总值	数字+单位	单个
国家格言	其他	句子
城市建设	百科实体	多个
道路通行	其他	单个
全名	其他	句子
重要港口	百科实体	单个
英文名称	其他	多个
体育	其他	句子
市长	人名	单个
所属经济区	地名	单个
精神内涵	百科实体	多个
城区人口	数字+单位	单个
城镇居民人均	数字+单位	单个
国家级开发区	其他	句子
赐建	人名	单个
地方名人	其他	单个
地理最高点	地名	单个
西班牙语	百科实体	多个
景区景点	百科实体	单个
人均支配收入	数字+单位	单个
城市形象歌曲	其他	句子
发行公司	其他	单个
世界之最	其他	句子
对白语言	其他	单个
宣传口号	百科实体	多个
邮递区号	数字+单位	单个
悠久文化	百科实体	单个
市花市树	百科实体	多个
市属高校	地名	多个
交通配套	百科实体	多个
始建时间	数字+单位	单个
会员人数	数字	单个
球队颜色	百科实体	多个
政区代码	数字	单个
河港	百科实体	多个
现任市委书记	人名	单个
民族	其他	单个
国际口岸	地名	单个
分布区域	百科实体	多个
旅游总收入	数字+单位	单个
重大事件	百科实体	多个
荣誉称号	其他	多个
巴西原首都	其他	单个
国歌	百科实体	单个
发展定位	其他	多个
当地高校	其他	单个
播放期间	数字+单位	单个
有关人物	人名	多个
海外侨胞	人名	多个
实际控制	百科实体	单个
市区常住人口	数字+单位	单个
区号	数字	单个
著名学校	地名	多个
