航行期	其他	句子
浮游动物数量	其他	单个
年均降水量	数字+单位	单个
长宽	百科实体	句子
东西宽	数字+单位	单个
南北宽度	数字+单位	单个
东西进深	数字+单位	单个
片长	数字+单位	单个
临近	百科实体	多个
地位	百科实体	单个
电话区号	数字	单个
地形地貌	其他	句子
海产	百科实体	多个
编剧	其他	单个
海峡岛屿	百科实体	多个
景点	其他	句子
MV导演	其他	单个
鸟类	数字+单位	单个
水深	数字+单位	单个
主演	人名	多个
著名景点	百科实体	多个
相邻地区	百科实体	多个
平均水深	数字+单位	单个
濒临省份	百科实体	多个
建议游玩时长	数字+单位	单个
原称	其他	句子
范围	百科实体	单个
体   积	数字	单个
原名	地名	单个
最深度	数字+单位	单个
海峡	地名	单个
地理位置	其他	句子
行政代码	数字	单个
主要出海口	百科实体	多个
平均盐度	数字+单位	单个
形成过程	其他	句子
大陆架宽度	数字+单位	单个
国家	百科实体	单个
解释	百科实体	单个
产业	百科实体	多个
南北宽	数字+单位	单个
最大海湾	百科实体	单个
人口	数字+单位	单个
结冰期	数字+单位	单个
附近岛屿	百科实体	多个
居民	百科实体	句子
最宽处	其他	句子
火车站	百科实体	多个
位 置	其他	单个
外文名称	其他	多个
所属专辑	其他	句子
较大海湾	百科实体	多个
东西跨度	数字+单位	单个
典型盐度	数字+单位	单个
水温	数字+单位	单个
类型	其他	单个
宽度	数字+单位	单个
阿尔巴尼亚语	百科实体	多个
适宜游玩季节	数字+单位	单个
气候	其他	单个
海面水温	数字+单位	单个
最大范围	数字+单位	单个
最大水深	数字+单位	单个
南北长度	数字+单位	单个
拍摄地点	百科实体	多个
平均气温	数字+单位	多个
所属区域	百科实体	单个
透明度	数字+单位	单个
海域长	数字+单位	单个
编曲	其他	单个
导演	人名	单个
海水温度	数字+单位	单个
所属城市	地名	多个
水层分层	百科实体	多个
周边地区	其他	单个
气候条件	其他	单个
潮汐高度	百科实体	句子
所属地区	其他	单个
南北	其他	句子
海区	其他	单个
发现者	其他	句子
缺点	其他	句子
走向	其他	句子
东西长度	数字+单位	单个
长度宽度	百科实体	句子
水域面积	数字+单位	单个
排名	其他	句子
水体体积	数字+单位	单个
坐标	数字+单位	多个
所属海位置	其他	句子
地区GDP	数字+单位	单个
负责管辖	地名	单个
发行时间	数字+单位	单个
中国领海	数字+单位	单个
沿岸气候	百科实体	单个
填词	其他	单个
海流方向	其他	句子
海生动物	百科实体	单个
命名人	其他	单个
海域宽	数字+单位	单个
海域气候	其他	单个
深度	数字+单位	单个
最大岛	其他	句子
较大岛屿	百科实体	多个
面积	数字+单位	单个
音乐风格	其他	单个
白海入海河流	百科实体	多个
位于	百科实体	单个
中文名称	其他	单个
平均水温	数字+单位	单个
周边国家	百科实体	多个
谱曲	其他	单个
植物	百科实体	多个
流速	其他	句子
形成时间	百科实体	单个
南部底线	百科实体	单个
体积	数字+单位	单个
注入主要河流	百科实体	多个
主要注入	百科实体	多个
具体名称	其他	句子
歌曲语言	其他	单个
年降水量	数字+单位	单个
海域面积	数字+单位	单个
建成航运	百科实体	单个
地理意义	其他	句子
最大深度	数字+单位	单个
长度	数字+单位	单个
流经国家	百科实体	多个
主要港口	其他	多个
全长	数字+单位	单个
渔产	百科实体	多个
主要海港	百科实体	多个
类别	其他	单个
周边港口	百科实体	多个
发现时间	数字+单位	单个
波斯语	百科实体	多个
沿岸国家	百科实体	多个
最狭处	数字+单位	单个
色彩	其他	单个
表面积	数字+单位	单个
别称	其他	单个
气候特征	百科实体	多个
建成区面积	数字+单位	单个
人均GDP	数字+单位	单个
总面积	数字+单位	单个
周边水体	百科实体	多个
容量	数字+单位	单个
主要群岛	百科实体	多个
周边国家地区	百科实体	多个
阿拉伯语	百科实体	多个
车牌代码	其他	单个
简介	百科实体	单个
归属	百科实体	单个
别名	其他	单个
地理面积	数字+单位	单个
歌曲原唱	百科实体	多个
机场	百科实体	单个
平均深度	数字+单位	单个
又名	百科实体	单个
门票价格	其他	单个
邮政区码	数字	单个
海水盐度	数字+单位	单个
法文名称	百科实体	多个
容积	数字+单位	单个
市花/市树	百科实体	单个
拍摄日期	数字+单位	单个
中文名	其他	单个
经纬度	其他	句子
方言	地名	多个
鱼类	其他	句子
年均气温	数字+单位	单个
所属大洋	其他	单个
地理坐标	其他	单个
特点	其他	句子
政府驻地	其他	句子
附近海峡	地名	单个
海域盛产	其他	单个
全面积	数字+单位	单个
南北跨度	数字+单位	单个
通航时间	数字	多个
长	数字+单位	单个
浮游植物数量	数字+单位	单个
水文特征	其他	句子
属性	百科实体	单个
地点	其他	单个
所处位置	其他	单个
平均风力	数字+单位	单个
著名事件	百科实体	单个
制片地区	其他	单个
行政区类别	其他	单个
自然资源	百科实体	多个
最窄处	其他	句子
上映时间	数字	单个
被发现时间	数字+单位	单个
港口	地名	单个
其它译名	其他	句子
南北长	其他	句子
连接陆地	其他	句子
形状	其他	句子
最深处	数字+单位	单个
相连湖泊	百科实体	多个
总容积	数字+单位	单个
外文名	其他	多个
所属洲	其他	单个
特殊地位	其他	句子
下辖地区	地名	多个
意大利语	百科实体	多个
释义	其他	句子
底栖动物种类	其他	句子
经纬	百科实体	句子
重要洋流	其他	句子
英文名称	百科实体	多个
主要河流	其他	单个
法语	百科实体	多个
海中盆地	其他	句子
歌曲时长	数字+单位	单个
印尼官方语	百科实体	多个
宽	其他	句子
西班牙语	百科实体	多个
大小	百科实体	句子
开放时间	其他	单个
发行公司	其他	句子
东西长	数字+单位	单个
对白语言	百科实体	多个
位置	百科实体	单个
特色水产	百科实体	单个
主要注入河流	地名	单个
发现人	百科实体	单个
白海的海湾	百科实体	多个
盐度	数字+单位	单个
票房	数字+单位	单个
占地面积	数字+单位	单个
周边海域	百科实体	多个
蓄水量	数字+单位	单个
所属国	其他	单个
定义	百科实体	单个
连接海域	其他	句子
涉及业务	百科实体	多个
沿岸国	百科实体	多个
气候类型	百科实体	单个
拉丁语	百科实体	多个
注入河流	百科实体	多个
性质	其他	单个
主要临国	百科实体	单个
主要生物	百科实体	单个
海湾水温	数字+单位	单个
最宽范围	数字+单位	单个
主要岛屿	百科实体	多个
沿岸港口	百科实体	多个
