地区	地名	单个
河中岛屿	百科实体	多个
陆地自然带	百科实体	单个
片长	数字+单位	单个
名誉	其他	句子
地位	其他	句子
年平均径流量	数字+单位	单个
起名人	其他	单个
蒙语名	其他	句子
地址	地名	单个
电话区号	数字	单个
年平均流量	数字+单位	单个
编剧	人名	单个
重要城市	地名	多个
所在大洲	其他	单个
汛期	数字+单位	单个
其他	其他	句子
流经国家数量	数字	单个
河源海拔	数字+单位	单个
著名景点	其他	句子
主演	人名	多个
河源	地名	单个
所在洲	其他	单个
灌溉地区	数字+单位	单个
所在地	其他	句子
起点	其他	句子
平均水深	数字+单位	单个
最佳游玩季节	数字+单位	单个
建议游玩时长	数字+单位	单个
特色风景	其他	单个
径流量	数字+单位	单个
地理位置	其他	单个
流入	百科实体	单个
行政代码	数字	单个
主要出海口	百科实体	多个
河网密度	数字	多个
入海口	其他	句子
藏文拼音	百科实体	多个
国家	其他	单个
南源源于	地名	单个
年径流量	数字+单位	单个
人口	数字+单位	单个
人类发展指数	数字	单个
流域主要气候	百科实体	多个
结冰期	数字+单位	单个
游玩季节	其他	单个
火车站	百科实体	单个
级别	其他	句子
主流	百科实体	单个
注入海洋	其他	单个
外文名称	其他	多个
流经主要城市	百科实体	多个
东西跨度	数字+单位	单个
典型盐度	数字+单位	单个
中源源于	百科实体	单个
海拔高程	数字+单位	单个
雅库特语	其他	句子
拼音	百科实体	多个
源头海拔	数字+单位	单个
类型	其他	单个
简称	其他	单个
名称来源	其他	句子
古称	百科实体	多个
适宜游玩季节	其他	单个
河道全长	数字+单位	单个
上 游	其他	单个
最大水深	数字+单位	单个
流域范围	百科实体	多个
河口流量	数字+单位	单个
拍摄地点	百科实体	多个
主体民族	百科实体	多个
主要分支	百科实体	多个
历史名称	其他	句子
导演	人名	单个
干流流经区域	百科实体	多个
所属城市	其他	句子
气候条件	其他	单个
流量	数字+单位	单个
俄语	其他	单个
-位置	地名	单个
平均流量	数字+单位	单个
imdb编码	其他	单个
所属地区	地名	单个
总长	数字+单位	单个
注入水域	百科实体	单个
源头	其他	句子
所处大洲	地名	单个
省树省花	百科实体	多个
最佳旅游时间	其他	单个
干线全长	数字+单位	单个
纬度坐标	其他	句子
维文名	百科实体	多个
流域	百科实体	单个
美誉	其他	句子
建议游玩时间	数字+单位	单个
主要支流	百科实体	多个
所在国家	其他	单个
流域面积 	数字+单位	单个
坐标	数字+单位	多个
流域气候	百科实体	单个
水源海拔	百科实体	多个
发源于	其他	句子
历史来源	百科实体	句子
流入地	百科实体	单个
河流类型	其他	句子
俄文名称	其他	句子
干流长度	数字+单位	单个
水源	地名	单个
发源	其他	句子
年均径流量	数字+单位	单个
面积	数字+单位	单个
出品公司	百科实体	多个
径流总量	其他	句子
流经国度	百科实体	多个
位于	其他	句子
河口坐标	其他	单个
流经地	百科实体	多个
中文名称	其他	单个
周边国家	百科实体	多个
注入地	其他	单个
干流全长	数字+单位	单个
三源汇合处	其他	句子
所属国家	其他	句子
注入主要河流	百科实体	多个
法语名	百科实体	多个
流向	其他	单个
终点	百科实体	单个
源头位置	百科实体	单个
平均坡降	数字+单位	单个
河流源头	百科实体	单个
年均流量	数字+单位	单个
河流量	其他	句子
干流	其他	单个
补给	其他	句子
所在地区	其他	句子
海域面积	数字+单位	单个
流域面积	数字+单位	单个
河段别称	其他	单个
现任领导	人名	多个
俄文名	百科实体	多个
地区生产总值	数字+单位	单个
长度	数字+单位	单个
长约	数字+单位	单个
流经国家	百科实体	多个
地 位	其他	句子
连接水域	其他	句子
主要港口	百科实体	多个
汇入河流	其他	句子
全长	数字+单位	单个
干流高程	其他	句子
干流长	数字+单位	单个
河长	数字+单位	单个
大致流向	其他	单个
汇合处	地名	单个
色彩	其他	单个
上游主要湖泊	百科实体	多个
河流面积	数字+单位	单个
别称	其他	单个
航程	数字+单位	单个
干流流域面积	数字+单位	单个
全程长度	数字+单位	单个
周边水体	百科实体	多个
最大流量	数字+单位	单个
落差	数字+单位	单个
车牌代码	其他	单个
所属地域	其他	单个
注入海域	其他	单个
别名	其他	单个
集水面积	数字+单位	单个
水利建设	百科实体	多个
河口平均流量	数字+单位	单个
制片人	百科实体	多个
机场	百科实体	单个
年流量	数字+单位	单个
门票价格	其他	单个
邮政区码	数字	单个
所在位置	其他	句子
河床坡降	数字+单位	单个
法文名	百科实体	多个
拍摄日期	数字+单位	单个
中文名	其他	单个
河流长度	数字+单位	单个
长度排名	其他	句子
北源源于	地名	单个
干流总长	数字+单位	单个
源出	其他	单个
上游	其他	单个
重要性	百科实体	单个
平均径流量	数字+单位	单个
流域国家	百科实体	多个
平均比降	数字+单位	单个
方言	其他	单个
地理坐标	数字+单位	单个
河段名称	百科实体	多个
年入海水量	数字+单位	单个
政府驻地	其他	单个
注入	其他	单个
极限流量值	数字+单位	单个
西班牙名称	百科实体	多个
省级河长	其他	单个
相关博物馆	其他	句子
南北跨度	数字+单位	单个
兵团段河长	其他	单个
发源地	其他	句子
长	数字+单位	单个
天然落差	数字+单位	单个
正源	其他	句子
地点	百科实体	单个
下游	其他	单个
所属大洲	其他	单个
藏文	其他	句子
河流全长	数字+单位	单个
出品时间	数字+单位	单个
制片地区	其他	单个
行政区类别	百科实体	单个
流经中要港口	百科实体	多个
上映时间	数字+单位	单个
水系长度	其他	句子
沿岸重要城市	地名	多个
葡萄牙语	百科实体	多个
河口	其他	单个
河流系统	其他	单个
语言	百科实体	多个
中游	其他	句子
流经	百科实体	多个
发源自	百科实体	单个
气候环境	百科实体	单个
外文名	其他	多个
流经地区	其他	多个
下辖地区	数字+单位	多个
释义	其他	句子
-坐标	数字+单位	多个
注入湖泊	其他	单个
景区等级	其他	句子
英文名称	其他	多个
总落差	数字+单位	单个
藏文音译	百科实体	单个
经度坐标	其他	句子
集水区面积	数字+单位	单个
注入大洋	其他	单个
西班牙语	其他	多个
最小流量	数字+单位	单个
开放时间	其他	单个
年平均输沙量	数字+单位	单个
源头坐标	其他	单个
来源	百科实体	单个
悠久文化	百科实体	单个
对白语言	其他	句子
位置	其他	单个
河道弯曲系数	数字	单个
总流域面积	数字+单位	单个
重点高校	地名	多个
世界长河排名	其他	单个
票房	数字+单位	单个
占地面积	数字+单位	单个
地处	其他	句子
蓄水量	数字+单位	单个
平均含沙量	数字+单位	单个
用途	百科实体	多个
封冻期	数字+单位	单个
气候类型	其他	句子
起源	其他	句子
干流流经地	百科实体	多个
性质	其他	句子
藏语	其他	单个
汇入	其他	单个
源于	地名	单个
所属水系	其他	单个
主要岛屿	百科实体	多个
属于	百科实体	单个
支流	百科实体	多个
