代表动物	百科实体	多个
典型地区	百科实体	多个
后果	其他	单个
主要植被	百科实体	多个
代表植物	百科实体	多个
最热月气温	百科实体	句子
平均气温	数字+单位	单个
降水特点	百科实体	单个
温度	其他	句子
典型分布区域	百科实体	单个
分布区域	其他	多个
解释	其他	句子
地址	其他	句子
典型城市	百科实体	多个
成因	百科实体	单个
分布大洲	百科实体	多个
主要分布区	其他	句子
旱季	数字+单位	单个
主要分布大洲	百科实体	多个
所属温度带	其他	单个
中文名	其他	单个
气候区分布	其他	句子
外文名	百科实体	多个
生长季	百科实体	句子
雨季	数字+单位	单个
农产品	百科实体	多个
最冷月气温	百科实体	句子
年均气温	数字+单位	单个
性质	其他	句子
特点	其他	句子
总体特点	其他	句子
别称	其他	单个
气候特征	其他	句子
分布地区	其他	句子
植被	其他	单个
分布范围	其他	句子
分布	其他	句子
显著特征	百科实体	多个
温度特点	其他	句子
气候特点	其他	多个
主要出现地区	地名	单个
主要分布地区	百科实体	多个
主要分布	百科实体	单个
代表城市	地名	单个
分布规律	其他	句子
类型	其他	单个
植被类型	百科实体	单个
