域名	其他	单个
时区	百科实体	单个
海域面积	其他	句子
GDP总计	数字+单位	单个
外汇储备	数字+单位	单个
现任领导	人名	多个
GDP	数字+单位	单个
党委书记	人名	单个
国家级新区	其他	单个
地区生产总值	数字+单位	单个
海岸线	数字+单位	单个
高等学府	地名	多个
电话区号	数字	单个
行政区划代码	数字	单个
回归时间	数字+单位	单个
重要城市	地名	多个
领导	人名	多个
省领导	人名	单个
风俗地区划分	百科实体	多个
著名高校	地名	多个
省份精神	百科实体	多个
民间信仰	人名	多个
行政长官	人名	单个
著名景点	百科实体	多个
省鸟	百科实体	单个
人均GDP	数字+单位	单个
gdp	数字+单位	单个
自治区主席	人名	单个
平均海拔	数字+单位	单个
省会	地名	单个
政治体制	百科实体	单个
法律体系	百科实体	单个
省树	百科实体	单个
特产	百科实体	多个
四大名湖	百科实体	多个
主要山脉	百科实体	多个
车牌代码	其他	句子
远古文明	百科实体	单个
国内生产总值	数字+单位	单个
历史名人	人名	多个
货币单位	地名	单个
别名	百科实体	多个
地理位置	百科实体	多个
行政代码	数字	单个
机场	地名	多个
省委书记	人名	单个
原省会	地名	单个
人均gdp	数字+单位	单个
邮政区码	数字	单个
建制时间	数字+单位	单个
最高山峰	百科实体	单个
现任行政长官	人名	单个
主要宗教	百科实体	多个
著名大学	地名	多个
高校	地名	多个
户籍人口	数字+单位	单个
人口	数字+单位	单个
人类发展指数	数字	单个
著名院校	地名	多个
四大名山	百科实体	多个
火车站	百科实体	多个
方言	百科实体	多个
省树、省花	百科实体	多个
政府驻地	地名	单个
外文名称	其他	多个
高等院校	地名	多个
最长山脉	百科实体	单个
轨道交通	数字+单位	单个
简称	其他	单个
主要城市	地名	多个
最大岛屿	地名	单个
行政区类别	百科实体	单个
省长	人名	单个
党政领导	百科实体	多个
省名来源	地名	多个
代表作家	人名	多个
气候条件	百科实体	单个
主要民族	百科实体	多个
官方语言	百科实体	多个
所属地区	地名	单个
根基文化	百科实体	单个
下辖地区	数字+单位	多个
海拔最高端	百科实体	单个
货币	百科实体	单个
旅游城市	地名	多个
人均生产总值	数字+单位	单个
名字来源	百科实体	单个
省树省花	百科实体	多个
基尼系数	数字	单个
历史名城	地名	多个
代表性名人	人名	多个
重要海港	百科实体	多个
主要河流	地名	多个
最大湖泊	百科实体	单个
国民生产总值	数字+单位	单个
生产总值	数字+单位	单个
首任行政长官	人名	单个
所属经济分区	地名	多个
最长河流	百科实体	单个
财政收入	数字+单位	单个
地理最高点	百科实体	单个
人口密度	数字+单位	单个
主要高校	地名	多个
首府	地名	单个
重点高校	地名	多个
重要口岸	地名	多个
省花	百科实体	单个
面积	数字+单位	单个
最大平原	百科实体	单个
主要地形区	百科实体	多个
道路通行规则	其他	单个
中文名称	其他	单个
地区代码	其他	单个
区名寓意	其他	单个
城市美誉	百科实体	多个
主要领导	人名	多个
齐鲁名人	人名	多个
代理省长	人名	单个
