东接	其他	句子
地区	其他	句子
主要物种	其他	句子
主要荣誉	其他	句子
称号	其他	句子
代表性动植物	百科实体	多个
所在地区	其他	单个
缓冲区面积	数字+单位	单个
地貌类型	其他	句子
设立时间	数字+单位	单个
东邻	其他	句子
长度	数字+单位	单个
湿地海域	数字+单位	单个
地位	其他	句子
地址	其他	句子
电话区号	数字	单个
主峰	其他	单个
动物资源	百科实体	多个
周长	其他	句子
类别	其他	句子
批 准 文 件	其他	句子
河长	其他	单个
森林植被	百科实体	多个
景点	百科实体	多个
管理单位	其他	句子
美称	其他	句子
别称	其他	句子
著名景点	其他	单个
海拔	数字+单位	单个
最高海拔	数字+单位	单个
保 护 区 级	其他	单个
所在地	其他	句子
总面积	数字+单位	单个
平均海拔	数字+单位	单个
主管部门	其他	句子
建议游玩时长	数字+单位	单个
自然类型	百科实体	单个
区域类型	数字+单位	单个
管理机构	其他	句子
建成时间	其他	句子
景观	百科实体	多个
车牌代码	其他	单个
区域面积	数字+单位	单个
保护区域	数字+单位	单个
地理位置	其他	句子
别名	其他	句子
景点级别	其他	单个
批准成立机关	其他	句子
成立于	数字+单位	单个
机场	百科实体	单个
保护区面积	数字+单位	单个
保护目标	其他	句子
岛屿	数字+单位	单个
门票价格	数字+单位	单个
旅游景区等级	其他	句子
最新荣誉	其他	句子
地貌	其他	句子
所在山脉	其他	单个
陆地面积	数字+单位	单个
设置时间	数字+单位	单个
人口	数字+单位	单个
主要保护植物	其他	单个
中文名	其他	句子
景区面积	数字+单位	单个
北接	其他	句子
核心区面积	数字+单位	单个
游玩季节	其他	单个
级别	其他	单个
方言	其他	单个
地理坐标	百科实体	句子
特点	其他	句子
等级	其他	单个
主要景区	其他	句子
外文名称	百科实体	多个
最高点	其他	句子
珍稀植物	百科实体	多个
保护类别	其他	句子
土地总面积	数字+单位	单个
重点保护物种	其他	单个
类型	其他	句子
简称	其他	句子
批准文号	其他	句子
实验区面积	数字+单位	单个
属性	其他	句子
始建于	数字+单位	单个
地点	其他	句子
海拔高度	百科实体	单个
对象	其他	单个
地势	百科实体	句子
适宜游玩季节	数字+单位	单个
气候	其他	句子
建立时间	数字+单位	单个
名称	其他	句子
物种	其他	单个
保护区类别	其他	句子
最高峰	其他	句子
所属区域	其他	单个
行政区类别	其他	单个
功能划分	百科实体	多个
荣誉	其他	句子
景区级别	其他	句子
所属城市	其他	句子
保护区长宽	百科实体	多个
气候条件	其他	句子
游玩时长	数字+单位	单个
批准机关	其他	句子
保护面积	数字+单位	单个
外文名	其他	多个
最低点	数字+单位	单个
所属地区	其他	单个
管 理 机 构	其他	句子
下辖地区	百科实体	多个
珍稀动物	百科实体	多个
区海拔	数字+单位	单个
时间	数字+单位	单个
批准机构	其他	单个
相关景点	百科实体	多个
植物资源	百科实体	多个
1994年12月	百科实体	单个
成立日期	数字+单位	单个
森林覆盖率	数字+单位	单个
批准建立时间	数字+单位	单个
景区景点	百科实体	多个
组成	百科实体	多个
开放时间	数字+单位	单个
批次	数字	单个
组织机构	数字+单位	单个
批准单位	其他	句子
位置	其他	句子
生态	其他	句子
始建时间	数字+单位	单个
地理地貌	其他	单个
景区特色	其他	句子
成立时间	数字+单位	单个
保护类型	其他	句子
深度	数字+单位	单个
占地面积	数字+单位	单个
高度	数字+单位	单个
保护区级别	其他	单个
世界遗产类型	其他	单个
生态特征	其他	句子
气候带	其他	句子
面积	数字+单位	单个
年平均降水量	数字+单位	单个
特有资源	其他	单个
保护对象	其他	句子
保护物种	其他	多个
气候类型	其他	句子
批准时间	数字+单位	单个
位于	其他	句子
保护区类型	其他	句子
保护等级	其他	单个
参观地点	百科实体	多个
森林覆被率	数字+单位	单个
中文名称	其他	句子
性质	其他	句子
英文名	百科实体	多个
区域	其他	句子
主要保护对象	其他	句子
主要生物	百科实体	多个
景区分类	其他	句子
西南连接	百科实体	多个
植被覆盖率	数字+单位	单个
所属国家	其他	单个
保护区等级	其他	句子
保护区总面积	数字+单位	单个
保护区对象	其他	句子
